--------------Harold & Kumar Go to White Castle (2004)
once and for all - окончательно, раз и навсегда Syn: finally
downsize - 1) уменьшать габариты и массу 2) сокращать (штат служащих)
slack - 5) лодырничать, сачковать, халатно относиться к обязанностям
crunching - решение числовых задач большого объёма, перемалывание чисел
applicant - 1) кандидат, кандидатура, претендент; соискатель (pretender , claimant)
med = medical - med school
trotter - 3) человек, который постоянно быстро ходит She was a trotter. — Она была непоседой. 4) (trotters) ножки (блюдо) 5) (trotters) ноги
trot - 1) а) идти рысью (о лошади) б) пускать рысью to trot a horse — пустить лошадь рысью 2) спешить, торопиться I must trot along — мне надо бежать
Negro - черномазый, черномазая
squad - 3) бригада (рабочих) 4) спортивная команда
squid – кальмар
potential - 1) потенциальный; вероятный, возможный; скрытый potential entrants — потенциальные конкуренты
potent - 1) могущественный; могучий, мощный, сильный potent ruler — могущественный правитель Syn: powerful , mighty
pancreatitis - панкреатит, воспаление поджелудочной железы acute pancreatitis — острый панкреатит chronic pancreatitis — хронический панкреатит
acute - 1) остроконечный, острый acute angle — острый угол
tenderness - 1) нежность, мягкость
diffuse - 2) рассеянный diffuse light — рассеянный свет
abdominal - 1) абдоминальный, брюшной abdominal pains — боли в животе
abdomen - 1) брюшная полость; живот
prevent - 2) мешать, препятствовать; оберегать Nothing shall prevent us from reaching our aim! — Ничто не сможет помешать нам достичь цели!
blaze - 1) гореть ярким пламенем
severe - 3) серьёзный, тяжёлый, сильный severe pain — сильная боль severe injuries — серьёзные повреждения severe wound — тяжёлая рана
discharge - 3) вытекание, выделение; спуск, сток, слив; опоражнивание 4) выделение
admission - 1) допущение, принятие; приём (в учебное заведение, клуб, общество)
apply - 1) обращаться с просьбой, (письменным) заявлением We applied to the authorities for assistance. — Мы обратились к властям за помощью.
MCAT - Medical College Admissions Test
moose - американский лось
ruck - а) куча, груда; кипа ruck of coals — куча, гора угля Syn: pile б) стог, скирда, копна
johnson - a man's penis
biyatch
hit the spot - полностью удовлетворять, приходиться по вкусу (о еде и питье) A glass of iced beer hits the spot on a hot day like this — Стакан ледяного пива как раз то, что нужно в такую жару
crave - 1) (crave for, crave after) страстно желать, жаждать; тосковать (о чём-л.) A woman who is soon to have a child often craves for strange foods. — Женщина, которая должна скоро родить, часто хочет поесть чего-нибудь необычного.
multiplex = multiplex cinema
supposedly - 1) по общему мнению 2) предположительно
wholesome - 4) здоровый, физически крепкий a plump rosy-cheeked wholesome young woman — пухленькая розовощекая пышущая здоровьем молодая женщина
worthless - 1) ничего не стоящий 2) никудышный; бесполезный, никчёмный 3) презренный, жалкий, ничтожный
dorm = dormitory
catcher - кетчер, принимающий (в бейсболе)
pitcher - питчер, подающий (особенно в бейсболе)
manned - 2) пилотируемый (человеком) ; человекоуправляемый manned flight — пилотируемый полёт
tollbooth = tollhouse - пост у заставы, где взимается дорожный сбор
gorge - а) жрать, обжираться, есть с жадностью, набивать брюхо
gorgeous - 3) замечательный, отличный, блестящий, превосходный (как выражение наивысшей оценки) That's gorgeous! — Вот это здорово! How gorgeous! — Как замечательно!
tunage = tune - 4) настроение, состояние
drive-through - A drive-through shop or restaurant is one where you can buy things without leaving your car.
thru = through
bearer - 3) посыльный
psst - (используется, чтобы незаметно привлечь чьё-л. внимание)
shitload - vulgar a large amount or number
non-issue - надуманный вопрос
ding-dong - 1) дин-дон, динь-дон (о двойном ударе в колокол, звуке колокольчика или похожем)
interject - вставлять замечания; мимоходом замечать, прерывать
interjection - 1) восклицание 2) междометие 3) перебивание
shack - лачуга, хижина, хибара
itty-bitty = itsy-bitsy – крошечный
explode - а) взрываться б) взрывать to explode a bomb — взорвать бомбу
rack - а) вешалка clothes rack — вешалка для одежды Syn: peg
stack - а) складывать в стог, в кучу; скирдовать
ramble - 2) = ramble on говорить много и сбивчиво Her letter doesn't contain any news, but it rambles on for pages. — В письме она не сообщает ничего нового, но оно растянуто на много страниц.
give a shit - To care about someone or something.
hibiscus – гибискус
petal – лепесток
ivy - плющ (обыкновенный) ivy climbs — плющ вьется
dime - монета в 10 центов (в Америке и Канаде)
nickel - монета в 5 центов
A kid toked up in the middle of my class — Один подросток закурил сигарету с марихуаной прямо во время занятий
sticky - Marijuana who's buds are lightly coated in a sticky natural resin.
internship - 2) практика, стажировка summer internship — летняя практика
kimchi - a Korean dish of spicy pickled cabbage
to get laid – трахнуться All I know is I got laid, twice. — Что точно, так это то, что мне удалось два раза перепихнуться.
ache - 3) (ache to) жаждать, страстно стремиться (к чему-л.) She is simply aching to get back. — Она просто жаждет вернуться домой.
understudy – дублёр
ditch - 8) бросать, покидать to ditch one's wife — бросить жену to ditch one's job — бросить работу
flyer - 1) лётчик, пилот Syn: airman , aviator , pilot
dishy - красивый, прекрасный, соблазнительный Syn: beautiful , handsome
destroyer - 1) разрушитель destroyer of family life — губитель семьи 2) эскадренный миноносец, эсминец
scag - a dirty slut, whore bitch My ex-girlfriend is such a scag! She did 3 guy's last night!
buda - marijana, weed, herb I need to get some Buda. 
persuade - а) склонить (к чему-л.) , уговорить (на что-л.) Try to persuade him to come. — Попытайся уговорить его прийти.
groin – пах
rookie - 1) новичок, новобранец (в армии или полиции) Syn: recruit
exaggerate - 1) гиперболизировать, преувеличивать; усложнять to exaggerate greatly / grossly — сильно преувеличивать
bond - 1) связь, узы close / firm / strong bond — тесная связь
stab - а) колоть, ранить кинжалом, ножом to stab smb. in the back — всадить, вонзить нож в спину кому-л to stab smb. to death — заколоть кого-л
wiper - 4) стеклоочиститель
hence - 4) поэтому, следовательно Syn: consequently , therefore
munchie - 2) (the munchies) внезапный приступ голода, жор to have / get the munchies — ощутить внезапное чувство голода
holocaust - а) (Holocaust) холокост, массовое уничтожение евреев фашистами Syn: genocide б) уничтожение, истребление; бойня; резня
plague - чума (инфекционная болезнь, вызываемая чумным микробом)
fever - 1) жар, лихорадка; какое-л. заболевание, основным симптомом которого является очень высокая температура
woozy - 1) одурманенный алкоголем, наркотиком 2) чувствующий головокружение, слабость или тошноту
no wonder - it is not surprising no wonder the waiters looked tired и неудивительно, нет ничего удивительного; что же удивляться, не приходится удивляться, вполне естественно
rebel - 1) повстанец, участник восстания, восставший; мятежник
spectacular - а) производящий глубокое впечатление; впечатляющий; эффектный Syn: imposing , impressive
bake - To smoke weed in a closed area.
bone - To have sexual intercourse.
scrub - б) очищать кожу (с помощью скраба)
stat - без промедления Syn: immediately
cardiac – сердечный
lose - 5) терять, упускать (время) , не воспользоваться (возможностью) to lose the tide — упустить время прилива There is not a moment to lose. — Каждая минута дорога. He didn't lose his time in eating. — На еду он не тратил много времени. Syn: waste
bore - 2) скважина Syn: crevice , cranny
gauze - б) марля
lung - лёгкое the lungs — лёгкие
gauge - а) мера, масштаб, размер, калибр
nerdy - 1) тупой, тормозной 2) скучный, занудный (о полностью увлечённом чем-л., особенно учёбой, человеке)
fricking - A word used by cowards who are too afraid to say "fucking"
tire = tyre - 1) шина; покрышка
tire - а) утомляться, уставать (от чего-л.) б) утомлять to tire down an animal — загнать зверя - tire to death
baptize - а) крестить, совершать обряд крещения
bosom - 3) душа, сердце
savior = saviour - 1) избавитель, спаситель
in a jiffy - одним духом, моментально, в один миг, мигом
jiff(y) - мгновение, миг, момент (moment , instant)
crust - 5) корка на ране, короста, струп
presently - 2) ныне, сегодня, сейчас, теперь Syn: now , at present
canary - 1) = canary bird канарейка
muster - а) созывать (собрание) ; собирать, организовывать (встречу)
hitch - 1) = hitch up продвигать вперёд толчками; подтягивать; натягивать, поднимая вверх He hitched up his bathing trunks. — Он подтянул плавки.
hike - 1) длительная прогулка; экскурсия; путешествие пешком
hump - 1) а) горбить, сутулить (спину) б) горбиться 6) а) трахать б) трахаться
poon = poontang - A woman's vagina, pussy, crotch
trim - pussy; usually good.(clean, shaved, not used alot.
quest - 1) поиск(и) in quest of smb. / smth. — в поисках кого-л. / чего-л. quest for oil — поиск нефти
kayaking - каякинг (сплав по рекам на каяке, экстремальный вид спорта)
kayak - 1) каяк (лодка) 2) байдарка to paddle a kayak — плыть на байдарке Syn: canoe
cashier – кассир
trustworthy - 1) заслуживающий доверия 2) кредитоспособный 3) солидный - trustworthy person
Let people know who might be fucking them over — Пусть люди знают, блин, кто может их обвести вокруг пальца
jaywalk - неосторожно переходить улицу (не обращая внимание на знаки)
pedestrian – пешеход
wad - 4) масса, куча, большое количество
shitwad - a certain amount of shit
bust - 7) бить, ударять
rile - 1) возмущать, раздражать, сердить It riled me that they were paying no taxes. — Меня возмущало, что они не платили налоги. 2) мутить (воду и т.п.)
tend - а) иметь тенденцию (к чему-л.) ; клониться, склоняться (к чему-л.) to tend to / towards radicalism — склоняться к радикализму to tend to the same conclusion — склоняться к тому же решению it tends to become hot in the afternoon — после полудня обычно становится жарко
multiple - 2) многократный; множественный, неоднократный, повторяющийся multiple prediction — множественный прогноз multiple cooking — многократная варка
multiply - а) увеличивать, умножать (количество чего-л.)
coyote - луговой волк, койот
combat - бой, сражение
gazelle – газель
maul - 1) булава 2) а) тяжёлая киянка, тяжёлый деревянный молот (используемые в кораблестроительстве, работе с деревом, в шахтах) б) кувалда 3) страшной силы удар 4) схватка за мяч (в регби)
maul - To make out with someone
mush - 1) путешествовать по снегу с помощью собачьих упряжек 2) управлять собачьей упряжкой
in no time - моментально, мгновенно, живо, мигом; ? в мгновение ока, в два счёта
oi = hey
whereas - тогда как
poser - a person who acts in an affected manner in order to impress others
fudge - чушь!, вздор!, чепуха!
persecution - гонение, преследование, травля; приставание, надоедание
poverty - 1) бедность, нищета, нужда, скудость
condiment - приправа, специи (relish)
glider - 1) планер to fly a glider — лететь на планере to launch a glider — запускать планер to tow a glider — буксировать / тащить планер
chuck - 1) бросать; кидать; швырять He chucked a pebble at me. — Он бросил в меня камешек.
lot - а) участок земли parking lot — место стоянки автотранспорта building lot — участок под застройку, строительный участок (plot)
epiphany – прозрение
stall - а) глохнуть (о двигателе) He panicked when the car stalled. — Его охватила паника, когда машина заглохла.
comeback - 5) реплика, возражение 6) ответ; язвительное замечание; остроумное высказывание
worthwhile - стоящий, дающий результат worthwhile experiment — полезный опыт
beats me - A phrase meaning 'i dont know.' Usually used when some one asks you something you should know, or when your particularly clueless about any situation.
lobby - а) вестибюль; приёмная; фойе Let's meet in the lobby. — Давай встретимся в вестибюле.
suave - учтивый, обходительный; вежливый Syn: urbane
sophisticate - утончённый человек, интеллектуал (разбирающийся в искусстве, моде и других социально значимых сферах)
sophisticated - 1) утончённый, рафинированный, изысканный a sophisticated lifestyle — утончённый образ жизни
attorney - 2) адвокат 3) атторней, прокурор
accomplice - сообщник, соучастник (преступления)
sketch - 1) эскиз, набросок
--------------Harold & Kumar Escape from Guantanamo Bay (2008)
bay – бухта, залив
bloom – цветение, цвести
bless – благословлять
sacred – святой, священный
credible – вероятный, правдоподобный
shower – душ, душевая, принимать душ
remind – напоминать
burger – гамбургер
pubis – лобок
pubes – волосы на лобке
wipe – вытирать, протирать, вытирание
wee – мочиться, писать, делать пи-пи
ghost – приведение, призрак
hater – ненавистник
menace – угроза, опасность, угрожать, запугивать, пугать
above – выше
below – ниже
motherfucker – ублюдок, эмоциональное название чего-либо, хреновина
fucker – козел, придурок, сексуальный партнер
fucking – проклятый, чертов, хренов
rug – ковер, плед, накидка, укрываться пледом
thug – убийца, головорез, киллер
rub – тереть
realize – понимать, осознавать
stalker – охотник, упорный преследователь
stalk – преследование, преследовать, подкрадываться, выслеживать
med = medium – среднее число, средний
med = median – медиана, средний mid, middle
psych – психология, психотерапия, психиатр, психоаналитик, распсиховаться
totally – полностью, совершенно, безусловно (absolutely)
aside – в сторону, в стороне
search – обыск, розыск, искать, разыскивать
random, casual – случайный, бессистемный, нерегулярный
ethnicity – этническая или расовая принадлежность
illegal – противозаконный, нелегальный, запрещенный
assume – допускать, предполагать
assuming – при условии что
barely – просто, едва, лишь
bitch – сука, жаловаться, ворчать, скулить
narcotic – наркотик, снотворное, наркотический, снотворный
minority – меньшинство
racial – расовый
government – правительство
fluster – беспокойство, волнение
appreciate – понимать, принимать во внимание, воспринимать, улавливать (разницу)
‘cause = because – потому что, так как
bouquet – букет (цветов), комплимент
florist – торговец цветами, цветовод
nightmare – кошмар, страшный сон
leash – поводок, цепь, держать на привязи
appointment – назначение, должность, место
major – майор, мажор, старший, главный
sweetheart – возлюблен(ая, ый)
rape – изнасилование, насиловать
rapist – насильник, виновный в изнасиловании
assuming - если; при условии, что
little – less – least
exactly – в точности, точно, именно, совершенно верно!
chick, chicken – цыпленок
boner – промах, просчет, грубая ошибка
ruin – разорение, крах, развалины, руины, разрушать, уничтожать, портить
piss – моча, мочиться, мочеиспускание
retard – медлить, мешкать, отставать
weed – табак, трава, сорняк, полоть
smokeless – бездымный
bong – кальян
society – общество
truly – правдиво, искренне, поистине
genius – гений
deodorizer = deodorant – дезодорант
fan – вентилятор, веер, обдувать
expunge – уничтожать, разрушать
inaugural – вступительный
ma’am = madam – госпожа, сударыня
pipe – курительная трубка, трубопровод, труба
tobacco – табак
marijuana – марихуана
hemp – конопля
marshal – маршал (военный термин)
pain – боль, причинять боль, болеть
amount – величина, количество
miss – пропустить, прослушать
magnitude – величина, размеры
representative – представитель, делегат, уполномоченный
agency – агентство
alert – тревога
importance – важность, значимость
issue – спорный вопрос, предмет спора
chairman – председатель
exhilarate – веселить, развлекать, подбодрять, воодушевлять (cheer)
weird – жуткий
descent – десант
convenient – удобный
innocent – невинный человек, невиновный
virgin – девственница, девственник, чистый, нетронутый, Дева
donate – дарить, жертвовать
tot – малыш
tax – налог
sink – раковина
pretty – довольно, достаточно
hero – герой, кумир
donut = doughnut – пончик
exist – существовать
bet – пари, держать пари, биться об заклад
fag – тяжелая работа, нудная работа, трудиться, корпеть
mayo = mayonnaise – майонез
extra – дополнительный, высшего качества, дополнительно, высший сорт
wrist – запястье (руки)
swell – опухоль, надуваться, разбухать, опухать
cheetah – гепард
hit – натолкнуться, достичь, достигать, удариться
wallet – бумажник
dale = vale = valley – долина
ghetto – гетто
complain – жаловаться
vagina – влагалище
pussy – влагалище
patriotic – патриотический
since – с тех пор, начиная с
graduation – выпускной
jumpsuit – комбинезон
expose – обнажать, показывать, выставлять на показ
topless – с обнаженной грудью, без верха
hype – активная реклама, очковтирательство
trend – курс, направление, тенденция
hence – с тех пор, с этого времени, поэтому, следовательно
bother – надоедать, докучать
relative – родственник
cute – прелестный
adorable – обожаемый, милый, очаровательный
adore – обожать, почитать
fugitive – беглец, беженец
booby – дурак, болван
estate – поместье, имение, участок
loan – прокат, временное пользование
dangle – болтаться, свисать, качаться
necessary – необходимо важные вещи, необходимый, нужный
fee – вознаграждение, гонорар, ЗП
cage – клетка, тюрьма, кабина лифта
peaceful – мирный, миролюбивый
offensive – обидный, оскорбительный
offend – обижать, оскорблять
dialect – диалект
cooperate – сотрудничать, содействовать
sentence – осуждение, приговор
gibberish – невнятная, бессвязная речь
disturb – беспокоить, тревожить
mind – возражать
grade – класс
grader – ученик
although – не смотря на то, что
poem – стихотворение
creative – творческий
embarrass – смущать, сбивать с толку
sexy – сексуальный, неприличный
professor – профессор
stress – гнет, напор, давление, напряженное состояние
copacetic, copasetic – отличный, прекрасный, в самый раз (excellent)
downstream – вниз по течению
upstream – против течения
rip – разрезать, распарывать, рвать, раскалывать, распиливать
strut – поддерживать, подпирать
generic – родовой; характерный для класса, вида
direction – адрес
punk – проститутка (prostitute) (панк)
hydrant – кран (fire hydrant – пожарный кран)
purpose – намереваться, иметь цель, вносить предложение (propose)
report – сообщать
abandon – покидать, оставлять
register – регистрировать (брака), регистрация
witness – свидетель, очевидец, понятой
sheriff – шериф
soda – газированная вода
ignorant – вульгарный, невоспитанный, невежественный
HIV – human immunodeficiency virus
harvest – урожай, собирать урожай
necessary – очевидный, не требующий доказательств
orthodontist – врач зубов (расположение)
console – пульт управления
actually – в настоящее время, теперь, как ни странно, как ни удивительно
glory – популярность, слава
glorious – знаменитый, прославленный
cross – крест, распятие
cellphone – сотовый телефон
honestly – честно, искренне, правдиво
positive – положительный
landscape – ландшафт, пейзаж, панорама
straighten – выпрямляться, разгибаться
DSL – digital subscriber line
subscriber – абонент, подписчик
plug – вставлять вилку в розетку
unplug – вынимать вилку из розетки
portable – портативный, переносной
cuss – ругательство, проклятие, сквернословить, ругаться (curse)
cost – цена, стоимость, стоить
afford – быть в состоянии, позволить себе
worth – достойный, заслуживающий
turd – дерьмо (о человеке)
golf – гольф, играть в гольф
stinky = stinking – вонючий
smelly – вонючий
fetid – вонючий
nonsense – абсурд, бессмыслица
guest – гость, приглашенное лицо
shit – гадить
shat – пр. время от shit
bunch – связка, пучок, пачка
redneck – неотесанный человек, деревенщина
inbred – врожденный, заложенный природой
basement – подвал
basically – в основном, по существу
creep – наводить ужас, ползать
creepy – вызывающий страх, бросающий в дрожь
towards – по направлению к
lighter – зажигалка
light – свет, освещение
clown – клоун
monster – чудовище, урод
claw – коготь, клешня, лапа, рука, царапать, скрести, рвать когтями
criticize = criticise – критиковать
deformity – дефект, недостаток, уродливость
rid – освобождать, избавлять
neighbor = neighbour – сосед, соседка
sibling – брат, сестра, потомство одних родителей
sib – кровный родственник
ought – моральное обязательство, долг, обязанности
judge – судья, судить, выносить приговор
tough – Грубо! Жестко!
whip – кнут, хлыст, сечь, хлестать
douche bag – сволочь
douche – душ, принимать душ
agony – мука, мучение, страдание
pretend – притворяться, прикидываться, претендовать, прилагать усилия
puny – слабый, неопытный
satisfy – удовлетворять
disaster – беда, бедствие, несчастье
wed – жениться, выходить замуж
fuck up – портить, обламывать, напортачить
admit – соглашаться
jealous – ревнивый, завидующий
potential – потенциальный, возможный
pothead – травокур, любитель травки
plow = plough – плуг, вспахивать, пахать
circumcise – совершать обрезание
tonsil – миндалевидная железа
bonfire – костер
KKK – Ku-Klux-Klan
Jew – еврей
stitch – шов, шить, строчить, пришивать
gross – большой, крупный, толстый
pecker – клюв, нос, половой член
heck – черт, к черту, черт побери
keg – бочонок до 10 галлонов
lug – волочить, тянуть, тащить
marshmallow – суфле
mushroom – гриб
graham – непросеянный, грубого помола
embassy – посольство
honk – гудеть, сигналить
prior – настоятель, босс, предшествующий
effort – усилие, попытка
bureau – бюро, комитет
ascent – подъем
descent – спуск
diverse – иной, различный, несходный
appreciation – признательность
wise-guy – умник, всезнайка
buttock – зад, ягодица (butt, breech)
butt – бочка, бочонок
occur – происходить, случаться, совершаться (happen)
additional – дополнительный, добавочный
supplementary – дополнительный
supplement – добавлять, пополнять
revision – пересмотр, проверка
discard – отказываться, оставлять, избавляться
discards – брак, отходы
remark – замечание, замечать, обнаруживать, подмечать
unit – часть, элемент, блок, узел, секция
unite – объединять, соединять
resilient – жизнерадостный, неунывающий
porch – крыльцо, подъезд, веранда
kike, hebe – еврей
downright – решительно, прямо, откровенно
lynch – расправляться самосудом
fart – пукать
flag – знамя, флаг, подавать сигнал, попросить остановиться
though – хотя
engine – машина, двигатель, мотор
bumpy – ухабистый, тряский
plot – план, схема, график, диаграмма
weave – плести, ткать
insult – обида, оскорбление, обижать, нападать, атаковать
plead – защищать подсудимого
lawyer – юрист, адвокат
amendment – поправка (к законопроекту), исправление, коррекция
tap – кран, затычка, прослушивание телефона
farmer – фермер, хуторянин, балда, балбес
upshot – развязка, заключение, результат
appendectomy – удаление аппендицита
unicorn – единорог
stand-in – замена, дублер, заместитель
tiny – очень маленький
nipple – сосок, соска, ниппель
teat – сосок, соска
convince – убеждать, уверять
shooting – стрельба, фото-съемка
go through – обыскивать, шарить, грабить
joint – сустав, стык, соединение, косяк
hectic – возбужденный, беспокойный, активный
roadblock – дорожная застава
smuggle – заниматься контрабандой
sticky – клейкий, липкий, вязкий
trooper – солдат, полицейский
arachnid – паукообразное насекомое
terror – страх, ужас, террор
homeland – родина
move along – проходить (дальше)
performance – действие, поступок, подвиг
deed – действие, деяние
detour – окольный путь, обход, объезд
whorehouse – бордель
brothel – публичный дом
resist – сопротивляться, воздерживаться
fault – дефект, недостаток, ошибка
lube = lubricant – машинное масло, смазка
feast – банкет, пир, торжество
jam – варенье, сжимать, давить, прищемлять
fella = fellow – приятель, товарищ
offence = offense – правонарушение, преступление, посягательство
supply – снабжение, поставка
stock – запас, резерв, ассортимент, инвентарь
make out – заниматься сексом
taste – вкус, попробовать на вкус, отведать, иметь привкус, различать на вкус
bump – столкновение, ударяться, подталкивать, толкать
pull over – съезжать на обочину и остановиться
pull – тянуть, тащить, дергать, выдергивать
achieve – добиваться, достигать
accomplish – совершать, выполнять, доводить до конца
benevolent – великодушный, благотворительный
generous – великодушный, благородный, добрый, щедрый
influence – влияние, воздействие
sore – больное место, рана, больной, воспаленный
never once – ни разу
sparkle – искрение, искорка, искриться, сверкать
come by – находить, приобретать, получать
prick – колоть, уколоть, проколоть, укол, шип, игла, колючка
brand – торговая марка, выжигать клеймо, прижигать
warn – предупреждать
dead – мертвый, покойник
die – умереть
mace – брызнуть слезоточивым газом, баллончик со слезоточивым газом
remain – оставаться, пребывать, оставаться в каком-либо состоянии, остатки, следы прошлого
friendship – дружба, дружеские отношения
relationship – любовные отношения, интрига, роман, отношения, родство
help up – помочь встать, подняться
limp – хромать, хромота, хромать, прихрамывать
during – в течение, во время
tear – рвать, разрывать
tore – пр. время от tear
massage – массаж, массировать
dorm = dormitory – студенческое общежитие, общая спальня
AIDS – Acquired Immune Deficiency Syndrome
tampon – тампон, вставлять тампон
twist – вывих
ankle – лодыжка (ноги)
make sure – убеждаться
meantime, meanwhile – тем временем
immediately – немедленно, тот час же
jet – реактивный
fuel – топливо, бензин
mention – упоминать, ссылаться на
smoothly – ровно, гладко, спокойно
banker – банкир
moron – болван, идиот
tension – напряжение, напряженное состояние, напряженность
stake – столб, кол, стойка
queer – гомосексуалист
bail – заклад, залог, поручительство
treat – обращаться, обходиться, вести себя по отношению к
guesthouse, inn, hotel, hostel – гостиница, отель, пансионат
ranch – ранчо
hypocritical – лицемерный
cater – обеспечивать, обслуживать, угождать
work out – отработать (долг)
knock out – одолеть, нокаутировать
encourage – одобрять, поддерживать, поощрять
disrespectful – непочтительный, невежливый
pardon – прощать, миловать, оставлять без наказания
proceed – продолжать (говорить, движение), возобновлять (дело, игру)
arrange – договариваться
sight – зрение, зрелище, заметить, высмотреть, увидеть
beneath – ниже, под, внизу
vicious – порочный, плохой, дурной
tool – мужской половой орган
irrationality – неразумность, нелогичность, непоследовательность
hark – слушать
harken – прислушиваться, слушать
waltz – вальс
rejoice – радовать, веселить, бодрить
bond – связь, узы, обязательство
wand – палочка, прутик, жезл
lifestyle – стиль жизни
make into – переделывать, превращать
awkward – неуклюжий, неловкий
bang – половое сношение
since – так как, поскольку

