----------------- Scary Movie 1
cricket – сверчок, крикет (игра)
chirp – чирикать, щебетать (о птицах)
hoot – крик совы, ухать (о сове)
pop – хлопать, щелкать, трещать
genie – джин (из сказок)
insides – внутренности
makeup – грим, косметика
squeal – визжать, пронзительно кричать
chime – выстукивать мелодию
psycho – псих, психопат, сумасшедший (madman)
rustle – хруст, треск, шорох, шелест, шуршание; хрустеть, шуршать
occur – приходить на ум
stick – завязнуть, застрять
apparently – очевидно, несомненно, вероятно, по-видимому
apparent – видимый, видный (не вооруженным глазом)
raid – набег, рейд, облава
stash – утаивать, припрятывать, убежище, тайник
nightgown – ночная сорочка
exorcist - заклинатель, изгоняющий беса
puke – рвота, рвотная масса, рвать, тошнить, блевать
slime – слизь
crucifix – распятие
cut out – вырезать
underwear – нижнее белье
stud – жеребец (о мужчине)
rush – подгонять, торопить, спешка, суета
champagne – шампанское
backup – дублер, замена, запасной, резервный
nasty – отвратительный, мерзкий, противный
Jacuzzi – джакузи
backstage – за кулисами, закулисный, находиться за кулисами (offstage)
rather – лучше, охотнее, предпочтительнее
bum – задница, бомж
circus – цирк
unthinkable – непостижимый, непонятный
brutal – жестокий, зверский, бесчеловечный
spree – веселье, шалости, кутеж (binge)
shake – встряска, дрожь, страх, дрожание
stir – мешать, помешивать, волновать, возбуждать, суета, суматоха
comb – прочесывать, тщательно искать, расчесывать, чесать, гребень, расческа
clue – улика, ключ к разгадке
suspect – подозреваемый, подозрительный человек, подозревать, полагать, сомневаться
custody – опека, опекунство, тюремное заключение, лишение свободы
ignorant – вульгарный, невоспитанный
victim – жертва
dawg – (friend, homeboy/girl)
election – выборы, избирательная комиссия
accident – несчастный случай, катастрофа, авария, случай, случайность
amen – аминь
soak – впитывать(ся), всасывать(ся), пропитывать(ся)
unzip – расстегнуть молнию
starve – голодать, морить голодом
convict – заключенный, каторжник, осужденный
manslaughter – непредумышленное убийство
fry – жарить(ся), казнить на эл. стуле, страдать из-за своей глупости
blame – порицать, осуждать, критиковать, винить, обвинять
unnecessary – лишний, не нужный, излишний (needless)
trunk – багажник автомобиля, ствол дерева,  хобот у слона
evidence – доказательство, свидетельство, улика
shorty – коротышка, недомерок
ingredient – ингредиент, составная часть, компонент
niggard – скупой, скряга
jumper – перемычка, соединительный кабель
cable – канат, трос, кабель
ledge – борт, край, карниз
jewelry – драгоценности, ювелирные изделия
drawer – ящик (выдвижной)
draw – тянуть, тащить, волочить
drawers – подштанники, кальсоны
pact – договор, пакт, соглашение (treaty)
gag – затычка, кляп
chill – охлаждать, замораживать
coincidence – случайное стечение обстоятельств, совпадение
cast – бросать, швырять, кидать
dingbat – глупый, тупой человек, ненормальный, псих
gum – жевательная резинка
statement – заявление, утверждение
lose – терять, утрачивать, лишаться
loser – неудачник
campus – территория университета
drool – слюна, течь, сочиться (о слюне)
due – должный, надлежащий, соответствующий
throughout – на всем протяжении (о времени)
questioning – допрос
serial – серийный, сериал
unbearable – невыносимый, несносный
bear – носить, нести, переносить, перевозить
loss – убыток, ущерб, потеря, проигрыш, поражение
moral – мораль, моральный
oral – оральный, устный
subscribe – подписывать(ся)
subscriber – абонент, подписчик
bald – лысый, лысеть
approve – одобрять, утверждать
trivial – тривиальный, банальный, незначительный, мелкий, ничтожный
prediction – предсказание, прогноз, пророчество
contest – соревнование, конкурс, состязание
grimy – запачканный, грязный, чумазый
crop – урожай, жатва, обрезать, подстригать, собирать урожай
crops – зерновые (о культурах)
hype – клевый, классный, активная реклама
expansion – рост, развитие, расширение, увеличение
node – узел; точка в которой кривая пересекает себя
hail – град, идти (о граде)
eden – рай
paradise – рай
pride – гордость, гордиться
proud – гордый
introduction = intro – введение, предисловие
innovate – вносить новшества
innovative – новаторский, передовой
efficient – эффективный
familiar – привычный
beneath – внизу, ниже
requirement – требование, необходимое условие
prompt – подсказка
within – в рамках (организации)
tip – совет, намек, подсказка (hint)
consistent – совместимый, согласующийся, непротиворечивый
divide – отделять, разделять, нарушать целостность, рассекать, делить
divider – разделитель, делитель, распределитель
primary – что-л. первостепенной важности; основной, базисный, важнейший, главный
dock – щавель, док, вводить судно в док, стыковаться
scrub – мыть, скрести, отмывать, оттирать, очищать, отшелушивать кожу, щетка, скраб, отшелушивающее средство
external – внешний
internal – внутренний
amendment – поправка (к законопроекту)
bloat – раздуваться, пухнуть, надуваться
constipation – запор
boil – нарыв, фурункул, кипеть, бурлить
walnut – грецкий орех
rot – гниль, труха, гнить, портиться, разлагаться (decay)
rotten – прогнивший, гнилой, тухлый
wrestle – борьба, бороться, заниматься борьбой
earring – серьга
Vaseline – вазелин
crunch – хруст, треск, хрустеть
contestant – конкурсант, участник, соперник
competition – конкурс, соревнование
applause – аплодисменты
dramatic – драматический, волнующий
sob – рыдать, всхлипывать
winner – победитель
onstage – на сцену, на сцене
jumpy – нервный, неспокойный
lately – в последнее время, на днях
slice – ломтик, часть, доля, резать ломтиками, нарезать, разрезать
snicker = snigger – хихиканье, хихикать
peek – быстрый взгляд, взгляд украдкой, подглядывать
append – прилагать, прибавлять (что-л. к книге, документу)
attach – прикреплять, прилагать
hip – бедро
dispatch – отправка, отсылка (курьера, почты) посылать, отправлять, отправлять
dispatcher – диспетчер, экспедитор
wail – вопить, выть, причитать, оплакивать
twig – веточка, прут, ветка
snap – треск, щелканье, щелчок, моментальный снимок, мгновенная фотография
gasp – открыть рот (от удивления), ловить воздух, задыхаться
worth – достойный, стоящий
bust – бюст; сломать, разрушать, прекращать
official – официальный, служебный, должностной, связанный с исполнением служебных обязательств
badge – эмблема, значок
stick – класть, совать, ставить (помещать в определенное место); палка, прут, веточка
stick – держаться, придерживаться, липнуть, присасываться
darn – заштопанное место, штопка, штопать, чинить, проклинать, ругаться
piggy – поросенок
kitty – котенок
doggy – собачка
birdie - птичка
glimpse – быстрый взгляд, беглый взгляд, беглое знакомство, увидеть мельком
statement – заявление
tender – мягкий, нежный, ласковый
juice – сок
juicy – сочный, спелый, мясистый
overhear – подслушивать, нечаянно услышать
pissed – злой, сердитый, пьяный
piss – моча, пиво, любой некачественный алкогольный напиток
complicate – затруднять, осложнять, усложнять
inconvenience – неудобство, беспокойство
tragic – трагический, драматический, ужасный, печальный
classified – секретный, тайный (secret, confidential)
confidential – тайный, конфиденциальный
light – освещать, светить, свет, освещение, легкий
infestation – заражение паразитами
crock – горшок
inhale – вдыхать
exhale – выдыхать
fresh – свежий
feminine – женский
odor = odour – запах, аромат
itch – зуд, зудеть, чесаться
gain – прибыль, выгода (benefit)
haunt – проведать, навещать, призрак, привидение, место часто посещаемое призраком
cape – накидка, плащ с капюшоном; мыс
cheer-leader – группа поддержки
bleed – кровоточить, истекать кровью
suppose – быть обязанным, думать, полагать, предполагать
crack – треск, хруст
climax – наивысшая точка, кульминация, оргазм
wholesale – оптовая торговля, оптовый, оптом
sale – продажа, реализация, сбыт, распродажа, продажа с аукциона
sever – отрезать, разрубать, перерезать, отрубать (split)
sweater – свитер, тот кто потеет
ignore – игнорировать, пренебрегать, не придавать значение
reasonable – разумный, благоразумный, рациональный, здравый
reason – разум, рассудок, причина, повод, основание
greasy – сальный, засаленный, жирный, скользкий, грязный
grease – топленое масло, жир
jersey – свитер, хоккейный свитер, футболка, майка
giggle – хихиканье, хихикать
freak – каприз, причуда, наркоман, хиппи
freaky – причудливый, странный, сумасбродный (strange)
odd – нечетный, непарный
shove – пихать, толкать, сильный толчок, пинок
hormone – гормон
blouse – блузка, кофточка
button – застегивать
unbutton – расстегивать
slaughter – убой, забой (скота), массовое убийство, резня, бойня, убивать, совершать зверское убийство
bloodshed – кровопролитие, массовое убийство, резня, бойня
sweep – мести, подметать, сметать, смахивать; трубочист
grunt – ворчать, бормотать
snack – легкая закуска
rustle – хруст, шелест, шуршание, треск
maiden – незамужняя, девственный, нетронутый, начальный, первый (первый полет самолета, первая речь)
voyage – плавание, морское путешествие (journey)
sauce – соус, подлива
anon – скоро, вскоре
anon = anonymous – анонимный, безыменный, неподписанный
comprehensive – всесторонний, всеобъемлющий
favor = favour – расположение, благосклонность; поддержка, одобрение; любезность, услуга, одолжение
audience – публика, зрители, радиослушатели, телезрители
jeer – насмехаться, глумиться, высмеивать, зло подшучивать
garage – гараж
clang – лязг, звон, резкий металлический звук
sigh – вздох, вздыхать
whinny – тихо ржать
chug – пыхтение, пыхтеть (pant)
pant - пыхтеть (часто - при ходьбе, беге)
howl – вой, завывание, рев, стон, крик
urge – побуждение, толчок, подгонять, советовать, надоедать, приставать, убеждать, настоять
enjoy – наслаждаться
joy – радость, радоваться
mumble – бормотать, бормотание
shriek – пронзительный, резкий, дикий крик; визг
whoop – возглас, выкрикивать, кричать
flavor = flavour – вкус, привкус, аромат, запах; изюминка, острота, пикантность
fudge – сливочная помадка (вид сладостей)
squeak – писк, визг, пищать
precede – превосходить, быть впереди, занимать более высокое положение
appearance – появление, выступление, выход из печати
whimper – хныкать, хныканье
gut – кишка, пищеварительный канал, потроха, потрошить
rumble – греметь, грохотать, грохот, рокот
cackle – болтать, молоть языком, делать из мухи слона, болтушка, болтовня
slash – резать, рана, порез
gash – наносить глубокую рану, делать надрез, глубокая рана, порез (cut)
spill – проливать(ся), разливать(ся), расплескивать(ся), рассыпать(ся)
slit – делать длинный узкий разрез, резать в длину
peel – кожица, кора, шелуха, снимать кору, кожицу, шелуху, очищать фрукты, овощи
gimme = give me = gi’me дай! дай мне! дай сюда!
ketchup – кетчуп
spaghetti – спагетти
motive – мотив, побуждение, повод, причина
sequel – последствие, результат, следствие, продолжение
deviant – человек с отклонениями от нормы, отклоняющийся от нормы
glans – головка мужского полового члена
frenulum – уздечка
abstinence – воздержание, пост
discover – обнаруживать, раскрывать, узнавать, находить, делать открытие, открывать
copycat – подражатель, имитирующий, подражающий
maniac – маньяк, помешанный, безумный, маниакальный
woozy – чувствующий головокружение, слабость, тошноту; одурманенный алкоголем, наркотиком; чувствующий недомогание, слабость
stab – колотая рана, удар острым оружием, наносить удар (кинжалом), вонзать, ранить (острым оружием)
snarl – рык, рычание, рычать, огрызаться, сердить ворчать, возглас досады, раздражения
plumber – водопроводчик
leaky – имеющий течь, страдающий недержанием, несдержанный, болтливый, говорливый
leak – течь, утечка, пропускать воду, давать течь, подтекать, просачиваться
bloodbath – кровавая баня, массовое убийство
plant – растение, саженец, побег, сажать, сеять, засаживать
fisherman – рыбак, рыболов
bury – хоронить, зарывать в землю
connect – соединять(ся), сцеплять, объединять, устанавливать отношения/взаимоотношения, налаживать контакты
snatch – хватать, ухватить, украсть, стащить, быстрая кража, грабеж
------------------------------- Scary Movie 2
wrap – завертывать, сворачивать, закутывать, шаль, платок
lap – колени (верхняя часть ног у сидящего)
fare – стоимость проезда, плата за проезд
thump – тяжелый удар, глухой звук удара
pump – насос, помпа, работать насосом, качать, выкачивать, опорожнять
tickle – щекотание, щекотка, щекотать
unleash – спускать с привязи
assist – помогать, содействовать, оказывать помощь, поддержка, содействие, помощь
sorrow – горе, печаль, горевать, печалиться
release – избавлять, освобождать, выпускать на волю
merciful – милосердный, полный сочувствия
almighty – всемогущий, всесильный
worthless – ничего не стоящий, никудышный, бесполезный, никчемный, жалкий, ничтожный
everlasting – вечный, бесконечный, постоянный, утомительный, надоедливый
consign – передавать, поручать
tyrant – тиран, деспот (despot)
unholy – порочный, дьявольский, нечестивый
ritual – ритуал, церемония, обряд, ритуальный
hallow – святой, освещать
dozen – дюжина, масса, множество
geek – чокнутый, помешанный (на чем-л.)
gear – одежда; шестерня
jacket – куртка
tuck – складка,  делать складки, собирать складки
waste – расточительство, отходы, тратить в пустую; изматывать, изнурять, переутомлять
tub – бочонок, бочка, ванна
wedgie = wedgy – белье врезавшееся между ягодиц
yeast – дрожжи, закваска
psychic – психический
lotto – лото, лотерея
pole – столб, шест, полюс (северный, южный)
likely – вероятный, возможный, вероятно
require – требовать
requirement – требование
paranormal – сверхъестественный, сверхъестественное
investigation – (научное) исследование, расследование, следствие
consideration – размышление, рассуждение, рассмотрение
traumatize – травмировать
coed – студент, студентка, учащийся
coeducation = co-education - совместное обучение лиц обоего пола
disorder – беспорядок
eager – энергичный, активный (в желании, взгляде, жесте)
please - радовать, доставлять удовольствие; быть в радость, нравиться (кому-л.) ; угождать; быть довольным (кем-л., чем-л. - with) , получать удовольствие (от чего-л. - to do smth.)
pleased – довольный
massacre – резня, бойня, устраивать резню, убивать с особенной жестокостью
county - а) графство (административно-территориальная единица в Великобритании) б) округ (административно-территориальная единица в США)
awaken – будить, пробуждать, пробуждаться, просыпаться
participate – участвовать, принимать участие
refute – опровергать; доказывать ложность, несостоятельность
completion – завершение, окончание, заключение, конец, финал (conclusion, end)
complete – полный, законченный, завершать, заканчивать
insomnia – бессонница (sleeplessness)
establish – учреждать, устанавливать (отношения), устанавливать (факт), упрочивать (репутацию, положение в обществе)
various – различный, разный, разнообразный, многие, разные, разнообразный, многосторонний
direction – направление; руководство, инструкция; адрес (на письме)
bishop – епископ, слон (в шахматах)
pope – поп, священник, римский папа
tease – дразнить, поддразнивать
teaser – задира, любитель подразнить
temple – храм, церковь; висок
caretaker – сторож, ответственный за поддержание в порядке (дома, частной собственности)
resemblance – похожесть, схожесть, сходство
strike – ударять(ся), наносить удар, бить, удар, забастовка
striking – поразительный
clumsy – неловкий, застенчивый (awkward)
panties – трусики (женские)
rent – арендная плата, арендовать, брать в аренду
cute – привлекательный
belong – принадлежать, быть частью чего-л.
buster – кутеж, пирушка, попойка (spree)
squeeze – сжимать, сдавливать, стискивать, выжимать, выдавливать
tight – тесно, крепко, плотно, туго
royalty – авторский гонорар, отчисление, процент
fee - вознаграждение, гонорар, заработная плата
generation – поколение, совокупность людей родившихся в одну и туже эпоху
age – возраст, век, эпоха
aged – пожилой, в возрасте
flu – грипп
fatigue – усталость, утомление, безразличие, равнодушие, апатия
storage – место для хранения, склад, база, хранилище, кладовка
throughout – повсюду, все время, на всем протяжении
chickadee – синица (птица)
arrive – прибывать, достигать, приходить
handyman – разнорабочий
ovation – овация, бурные аплодисменты
shortly – скоро, вскоре (soon); коротко, кратко, сжато, лаконично (briefly)
jog - бегать трусцой
haircut – стрижка, прическа
chest – ящик, коробка, сундук, грудная клетка
grime – сажа, грязь, марать, пачкать
grimy – запачканный
grim – зловещий, мрачный, страшный
goon – киллер, убийца, головорез, наемный бандит; болван, тупица
possessed – одержимый, хладнокровный, владеющий собой
posses – владеть собой, сохранять терпение/спокойствие; владеть, обладать (какими-л. материальными объектами)
substantiate – обосновывать, доказывать
substantiated – обоснованный
appetizer – закуска
delicious – вкусный, приятный, восхитительный, прелестный, очаровательный
whisk – сбивалка (для яиц), веничек (для уборки), сбивать (белки), смахивать (крошки с колен)
pleasure – желание, воля, удовольствие, доставлять удовольствие
mutual – взаимный, обоюдный
pinch – щепать, ущипнуть, откусывать, отрезать
intimidate – пугать, запугивать
salesman – продавец, коммивояжер
anatomy – анатомия
stink – вонять, смердеть, вонь, зловоние
giblets – гусиные потроха
germ – бактерия, микроб, зародыш, эмбрион
oily – жирный, маслянистый
squint – косоглазие, (при) щуриться, жмуриться
uncanny – сверхъестественный, необъяснимый, поразительный, необыкновенный
pointy – заостренный, остроконечный, острый (pointed)
apart – в стороне, отдельно, в отдалении
middle name – второе имя
litter – туалет для животных (litter box)
commotion – беспокойство, тревога, суета, суматоха, шум, гам
contrary – вопреки
peek-a-boo – "куку" (игра в прятки с ребенком)
affair – дело, роман, любовная связь, событие, происшествие, инцидент
sleigh – сани, кататься на санях (sled, sledge)
toke - затягиваться (табачным дымом)
perm – химическая завивка
alike – одинаковый, подобный, похожий (similar)
orangutan – орангутанг
consider – рассматривать, обсуждать
poltergeist – полтергейст
verge – край, грань, обочина дороги
duct – трубопровод, труба, туннель, канал, проход
toss – бросать, кидать, швырять, подбрасывать, подкидывать
fellatio, cunnilingus, oral sex
hunk – физически красивый и сексуально привлекательный мужчина
rocket – ракета
emit – излучать, испускать, выделять (свет, тепло, запах)
dolt – болван, дурень (lamebrain)
bolt – болт, винт, шуруп; удар молнии, грома
starlet – будущая звезда, восходящая звезда (о талантливой актрисе, спортсменке)
panty-hose – колготки (tights)
determine – решать (decide)
react – реагировать, отзываться (respond)
lease – аренда, сдавать в аренду, брать в аренду (rent)
retail – розничная продажа, розничный, продавать в розницу
overseas – морской, заморский, заграничный, иностранный, за морем, через море, за границей, за границу
concentrate – сосредоточивать(ся); фокусировать(ся)
energy – энергия
ammunition – боеприпасы, снаряды, патроны
urban – городской
conserve – беречь, охранять, сберегать, хранить
goggle – защитные очки
principle – принцип
principal – ректор
detect – замечать, обнаруживать
crook – крючок, крюк, епископский посох, изгиб, загиб
walkie-talkie - воки-токи, переносная рация
furnace – печь, очаг, топка
mutilate – калечить, увечить
vote – голосовать, голосование, голос (на выборах)
kit – набор инструментов
booty = boody – попа, задница
innermost – глубочайший, сокровенный (о чувствах)
serpentine – извилистая дорога, змееподобный, виться, извиваться, двигаться змееподобно
merchant – лавочник, купец, торговец
trader – торговец (оптовый), биржевой маклер, спекулянт
barter – товарообмен, менять, обменивать, бартер
marine – солдат морской пехоты
thermal = thermic – термический, тепловой
gotcha = ( I have) got you
punk – панк, панк-рок
morphine = morphia – морфий
chloroform – хлороформ
beetle – жук
smack – отшлепать (по попе); хлопать, шлепать (slap)
chastity – девственность, непорочность, невинность (virginity)
crane – журавель, цапля; грузоподъемный кран
crouch - припадать к земле; согнуться, сжаться
lure – приманка; соблазн, соблазнять, завлекать, приманивать (tempt)
tempt – соблазнять, искушать
temptation – искушение, соблазн
seed – семя, семечко, зерно, семена
semen = sperm – сперма
----------------------- Scary Movie 3
shrink – уменьшать, сокращать, сжиматься, съеживаться, усадка, усушка, уменьшение
molecule – молекула
hydrogen – водород
tramp – бродяга, бродяжничать
cram – давка, толкотня, толпа; впихивать, втискивать, переполнять, пичкать
mound – холм, курган
precious – любимый человек, любимая
cornfield – кукурузное поле, поле, нива
corn – зернышко, зерновые
maize – кукуруза (corn)
elaborate – продуманный, скрупулезный, аккуратный, усердный
prank – выходка, шалость, шутка, проделка
phenomenon – событие, феномен, явление
terrestrial – земной, происходящий на суше, на земле, живущий на земле или в земле
hoax – обман, розыгрыш, подшутить, разыграть
augmentation – приращение, прирост, увеличение (increase, growth)
coverage – сфера, действие, рамки, границы, масштаб (scope)
hardship – трудности, невзгоды, тяготы жизни
especially – особенно, в особенности
sympathy – coчувствие, сострадание
faith – вера, доверие, вера в Бога
explanation – пояснение, объяснение, разъяснение (фактов, доводов)
adolescent – юный, молодой, юношеский, подростковый (youthful, young); молодой человек, юноша, девушка, подросток (youth)
gynecologist – гинеколог
for God’s sake – ради Бога, ради всего святого
traffic – движение, транспорт, дорожный, транспортный
stick – завязнуть, застрять
assignment – задание
commitment – обязательство
grateful – благодарный, признательный
rash – сыпь
trigger – спусковой крючок, спускать курок
spin – вращение, кружение, крутить, вертеть, выписывать круги
crib – детская кроватка, хижина, тюремная камера
chrome – хром (металл)
chroma – цветность
evict – выселять, лишать собственности по суду, выселенный арендатор/жилец
dreadful – отвратительный, страшный, ужасный, отвратительно, ужасно
dread – ужас, трепет, бояться, опасаться
terrible – horrible – dreadful
ghastly – жуткий, страшный, ужасный, отвратительный (terrible); страшно, ужасно
pathetic – жалкий, вызывающий презрение; грустный, задумчивый, печальный (sad)
reign – правление, царствование, царствовать, власть, господство
slick – гладкий, скользкий, сглаживать, полировать, прихорашиваться; ловкий, искусный, умелый
liar – лгун, лжец
denial – отказ (кому-л. в чем-л.)
pitch – поле, площадка (для игры в футбол, регби, крикет)
khaki – цвет хаки
whack – сильный удар, наносить звонкие удары, звук от удара
seizure – припадок, приступ
whup = whip – сечь, хлестать, шлепать
clergyman – священник
clergy – духовенство
pin – булавка, шпилька, прищепка, прикалывать, прикрепить, прокалывать, протыкать, придавить, прижать
wiener – сосиска, венская сосиска; дурак, козел
lingo – малопонятный жаргон, профессиональная фразеология
remarry – вступать в новый брак
shroud – саван (покров из белой ткани для покойников или вид рубахи в которой хоронят), покров, пелена
hardly – едва, еле, тяжело, с трудом, через силу
arrogant – заносчивый, высокомерный, надменный
consume – расходовать, тратить, потреблять, поглощать
consumer – потребитель
denounce – обвинять, осуждать, доносить
stoner – тот кто курит Cannabis
coffin – гроб, класть в гроб
resent – негодовать, возмущаться, обижаться
lid – крышка, закрывать крышкой
quantum – квант, фотон, квантовый; величина, количество (amount), объем
shy – застенчивый, робкий, стеснительный, пугливый, осторожный
shy away – сторониться, избегать, уклоняться
extreme – крайность
extremely – крайне, чрезвычайно
lighthouse – маяк
effort – усилие, попытка, напряжение
lawsuit – судебный процесс
spit – вертел, шампур, насаживать на вертел; плевок, слюна, мокрота, плевать(ся), выплевывать(ся), отхаркивать
spittle, saliva – слюна
dice – кости (игральные)
testicle – яичко
rock – скала, утес; убаюкивать, укачивать; рок-музыка
plenty – вполне, довольно (quite), весьма, чрезвычайно
rant – разглагольствовать, говорить насыщенно, изрекать
supernatural – сверхъестественный
meanwhile – тем временем, между тем (meantime)
brutal – бесчеловечный, жестокий, зверский (terrible, cruel)
prevent – предотвращать, предупреждать
contraction – сокращение (лингв.)
UFO – unidentified flying object - НЛО
architect – архитектор
inexorably – неумолимо, непреклонно
inexorability – неумолимость, непоколебимость, безжалостность
chore – рутинная работа, повседневная работа по дому, неприятная работа
ergo – итак, следовательно
thus – так, таким образом, в соответствии, соответственно
heir – наследник, преемник, продолжатель
sufficient – достаточный, обоснованный
imprint – отпечаток, след, отпечатывать, ставить штамп, оставлять след
summon – вызывать, позвать
glimpse – мерцать, слабо светиться, блеснуть, сверкнуть, мелькнуть, пронестись
spacecraft = spaceship
pose – поза, позировать, принимать позу
threat – опасность, угроза (danger)
award – присуждение (награды, премии), премия, награда, присуждать, награждать
steer – бык, вол (bullock, ox); следовать, идти (по определенному курсу)
overcome – побороть, победить, превзойти, преодолеть, подавить
therefore – поэтому, следовательно (and so)
suspicious – подозрительный, недоверчивый, вызывающий подозрение
suspicion – подозрение
towards – по направлению к, к
scramble – взбалтывать (обычно яйца для болтуньи), смешивать, перемешивать, приводить в беспорядок
filthy – запачканный, немытый, замаранный, нечистый (мерзкий, противный, неприятный, слякотный – о погоде)
scum – пена, пенка, накипь (в кастрюльке); отбросы, отходы, шлаки; снимать пену, образовывать пену, покрыться накипью; ничтожество, мразь, подонок, мерзавец, опустившийся человек
hideous – отвратительный, омерзительный, страшный, ужасный (gruesome)
creature – создание, творение
exclusive – недоступный, с ограниченным доступом, привилегированный
cellar – подвал, погреб (basement)
delivery – поставка, доставка; роды, принятие родов
bludgeon – дубинка, бить дубинкой
cudgel – дубина, толстая деревянная палка, колотить, бить палкой
shitter – туалет
bedpan – кроватный унитаз
gush – литься потоком, хлестать (о жидкости), прорываться, извергаться, излучаться
umbilicus – пупок
cord – веревка, шнур
fuse – плавка, процесс плавления, плавкий предохранитель, пробка, плавиться, сплавляться, сделать короткое замыкание; запал, фитиль
gray = grey
grayish = greyish – сероватый
–ish – (приблизительность признака) reddish – красноватый, palish – бледноватый
grotesque – гротеск, шарж, абсурдный, нелепый
insurance – страхование
clitoris – клитор
labium – губа (нижняя губа)
labia – мн. от labium
homeboy, homegirl, homie, homey – кореш
invade – вторгаться, захватывать, оккупировать
------------------- Scary Movie 4
slosh – литься, выплескиваться, хлестать (о жидкости), хлюпать, шлепать (по лужам)
splash – забрызгивать, брызгать, плескать, плескаться, бултыхаться, шлепать (по воде, лужам)
eerie – жуткий, зловещий, мрачный
whisper – шепот, шептать
crackle – потрескивать, трещать, хрустеть (crunch)
antidote – противоядие
whine – жаловаться (complain), плакать (whimper - хныкать)
obese – толстый
obesity – ожирение
brat – надоедливый ребенок, плохо воспитанный ребенок
sniffle – сопеть, хлюпать носом
electrician – электрик
scrutinize – внимательно изучать, пристально рассматривать
valve – клапан
enrol = enroll – записываться, вступать в члены (какой-л. организации), вносить в список, регистрировать
inspire – внушать, вселять (чувство и т.д.)
ultimately – в конечном счете, в конце концов
ultimate – последний, конечный, завершающий, окончательный
venom – яд
rattle – детская погремушка
rattle – греметь (посудой, ключами и т.д.)
vent – давать выход, изливать (чувства и т.д.)
burst – лопаться, взрываться
enormous – громадный, гигантский, огромный
burden – ноша, груз, тяжесть, бремя
meow – мяукать
screech, scream – визг, вопль
knack – склонность, особый талант
splat – звук шлепка, всплеска
whistle – свистеть
seagull = gull – чайка (птица)
overtime – сверхурочные часы, время; сверхурочно
alarm – боевая тревога, сигнал тревоги
alert – тревога, сигнал тревоги
buzz – гудеть, жужжать
bullion – слиток (золота, серебра)
bellow – мычать, реветь
quit – выходить из системы, завершать сеанс, бросать привычку, оставлять, покидать
purpose – цель; предлагать, вносить предложение (propose)
masculinity – мужественность
trash – мусор
reveal – обнаруживать, показывать, открывать, разоблачать
plausible – правдоподобный
bleat – блеять, мычать (о теленке)
cod – треска (рыба)
affect – трогать, задевать, оказывать влияние (о мыслях, чувствах)
blare – громко трубить, издавать громкий и пронзительный звук
sodium – натрий (хим.)
natrium – натрий (хим.)
cholesterol – холестерин
vegan – строгий вегетарианец
vegetarian – вегетарианец, вегетарианский
organic – естественный (natural)
manure – навоз, удобрение
seal – тюлень; печать, клеймо (stamp)
conventional – обычный, традиционный (usual, customary, habitual)
afford – (быть в состоянии) позволить себе
provider – поставщик; кормилец (семьи)
knob – шарообразная ручка (двери и т.д.)
muffin – кекс (пирожное)
jingle – звон, звенеть
slip – поскользнуться, вывихивать, подворачивать (ногу)
fall – падать, падение
whoosh – свист (рассекаемого воздуха), пронестись со свистом
squeak – писк, виз, пищать (о резком, неприятном звуке)
catatonic – бессознательный
presence – присутствие, наличие (нечто таинственное, мистическое, непонятная сила)
density – плотность (населения и т.д.)
vomit – рвота, рвотная масса, рвать, блевать (spew, puke)
fever – жар, лихорадка
synopsis – конспект, краткий обзор (summary)
sunstroke – солнечный удар
stroke – удар, инсульт, штрих
inspection – осмотр, обследование, экспертиза
lawn – газон, лужайка
glade – поляна, опушка
hire – нанимать, приглашать на работу
dental – зубной, стоматологический
opportunity – шанс, возможность (chance, break)
occasion – возможность, случай, шанс
gurgle – журчание, бульканье (воды), булькать, журчать
yowl – вой, выть (howl)
approve – одобрять
approval – одобрение
FBI – Federal Bureau of Investigation
investigation – расследование, следствие
override – переехать, наехать, задавить; отвергать, не принимать во внимание
accord – одобрение, согласие, соглашение, договор, аккорд, созвучие, гармония
according – соответственно, таким образом
buccaneer – пират, заниматься пиратством (pirate)
bulk – масса, объем (mass) (volume) емкость, груда, кипа
catheter – катетер (мед. инструмент)
fold – сгиб, изгиб, складка
lance – копье (spear) скальпель, ланцет (lancet)
mop – швабра, мыть, протирать шваброй, вытирать слезы, пот
doody = shit = caca = feces = faeces = poo = turd = excrement – фекалии, кал, испражнения, экскременты
suction – сосание, всасывание, засасывание
creak – скрип, скрипеть (дверьми)
expire – угасать, испускать последний вздох, скончаться, закончиться, истечь (о сроках) потерять силу (о законе)
muffle – приглушенный звук, глушитель, глушить, заглушать (звук)
mutter – бормотание, бормотать
retch – позыв на рвоту, рвота, рыгать (vomit, puke, spew)
shriek – визг, визжать
clatter – греметь, грохотать, шуметь
pigskin – свиная кожа, седло, футбольный мяч
cushion – подушка, подкладывать, подушку
jab – толчок, пинок, укол, прививка, пихать, толкать, сделать инъекцию
exclaim – восклицать, вскрикивать
claim – требовать, предъявлять требования
thwack – бить, колотить (палкой, кнутом) (bang, whack)
thrash – бить, пороть
monger – продавец, торговец, торгаш
doom – рок, судьба, фатум (fate) гибель, кончина, смерть (death) судный день, день страшного суда (doomsday)
decease – гибель, кончина, смерть (death); почить, скончаться, умереть (die)
thunder – гром, греметь, грохотать
rumble – громыхать, грохотать, греметь, урчать (в животе)
fierce – жестокий, лютый, свирепый
murmur – ворчание, ворчать, шепот, шептать
ding – звон колокола, звенеть (как металл когда по нему ударяют)
solenoid – соленоид (электротехника)
whirr – шум (машин) шуметь (о машинах) (buzz, hum)
grind – зубрила, студент любящий заниматься, ботаник; скучное задание, однообразная работа, скучная; размалывание (процесс) молоть, перемалывать, толочь, растирать в порошок
outfit – одежда, наряд, снаряжение, комплект одежды, обмундирование
fit – снаряжать, оснащать
scrap – объедки, остатки (пищи), отходы (производства); драка, схватка, потасовка, драться
strain – напряжение, нагрузка, переутомление, напрягать, натягивать, растягивать, напрягаться, переутомляться
stammer – заикание, заикаться
stutter – заикание, заикаться
response – ответ, отклик
respond – отвечать, реагировать, отзываться
attitude – отношение, позиция (к чему-л.)
debris – осколки, обломки, обрезки, лом, развалины, руины (здания, постройки), строительный мусор
clatter – стук, звон, лязг, громыхание, сильно греметь, грохотать, шуметь, цокать, стучать
pond – пруд, маленькое, озеро, искусственный водоем
regard – внимание, забота, беспокойство, расположение, уважение
blade – лезвие, клинок, лопасть (винта, пропеллера, весла)
squeak – писк, визг, пищать (о резком звуке)
stewardess – стюардесса, бортпроводница
gape – зевок, зевать, широко раскрыть рот (yawn)
so long – пока, до свидания, прощайте
devastate – истощать, опустошать, разорять (ravage)
ravage – грабить, опустошать, разорять
wail – причитание, оплакивание, выть, причитать, оплакивать (cry, howl)
bawl – крик (во всю глотку), орать (во всю глотку) (зазывать покупателей на рынке)
distant – дальний, далекий, отдаленный
clamor = clamour – шум, крик, шумные протесты, возмущения, шуметь, создавать шум, протестовать
hug – крепкое объятие, крепко держать, сжимать в объятиях
eyewitness – очевидец, свидетель (witness, eye-witness)
immunity – неприкосновенность, иммунитет, невосприимчивость (к какой-л. болезни, инфекции)
immune – неуязвимый, невосприимчивый
lump – опухоль, шишка, бугор, выступ, глыба, ком, крупный кусок
sneak – красться, подкрадываться, идти крадучись
snack – легкая закуска
snake – змея
blend – смесь, смешиваться
yelp – визг, лай, визжать, лаять, тявкать (scream, screech, squeal)
squeal – визг, вопль, визжать, кричать
goofy – бестолковый, глупый, тупой (foolish, silly)
laugh = laughter – смех, хохот (chuckle, giggle, titter) – хихиканье, хихикать
race – гонка, гонки, скачки, спортивная ходьба; раса, род, вид, нация, племя (species, genus)
truce – перемирие
grace – молитва перед едой и после еды, вежливость, учтивость, любезность, приличие
partnership – сотрудничество, компания, товарищество
cabin – хижина, хибара, будка, кабина, каюта
shack – лачуга, хижина
hut – лачуга, хибара, хижина, барак
mansion – большой особняк, большой дом, дворец
council – совет (орган государственной власти)
gavel – молоток (председателя собрания, судьи, аукциониста)
tide – прилив и отлив (на море, океане)
tidings – известия, новости, вести
tidy – аккуратный, опрятный, чистый (clean)
intention – намерение, стремление, цель, замысел (aim, goal, intent)
intend – намереваться, планировать (plan)
majority – большинство
minority – меньшинство
rap – стучать; ругать, критиковать; муз. стиль; стук; выговор, замечание, наказание, обвинение, реакция на что-л. отзыв о чем-л.
silence = quiet = calm
attract – привлекать, притягивать (внимание, инвестиции)
wiggle – покачивать(ся), ерзать, извиваться, изгибаться
wriggle – извивать(ся), изгибать(ся)
able – способный
ability – способность
slide – скользить, двигаться плавно без резких толчков
glide – скользить, двигаться плавно без резких толчков
consult – советоваться, консультироваться
elder – старший; старец, старейшина
gurgle = guggle – бульканье, булькать
slurp – причмокивать, чавкать
champ – причмокивать, чавкать
mankind – человечество, человеческий род, мужчины, мужской род (humanity, humankind, man)
genus – род, сорт, вид (sort, kind)
wisdom – мудрость
leadership – превосходство (в какой-л. области)
robe – халат, мантия, одеяние, надевать, одевать, платной шкаф, шифоньер
squint, strabismus, cross-eye – косоглазие
fight back – сопротивляться, давать отпор, сдерживать
adviser = advisor – советник, консультант
advise – советовать, консультировать
advice – совет, консультация
pentagram – пентаграмма
polarity – полярность
invade - вторгаться; захватывать, оккупировать
invader – захватчик, оккупант (usurper)
intrude – вторгаться, входить без разрешения, приглашения, навязываться, быть назойливым
shield – щит, защитное средство, защита
vulnerable – уязвимый, ранимый
vulnerability – уязвимость, ранимость, слабые места в системе защиты
cannon – артиллерийское орудие, пушка, пистолет, револьвер
sight – вид, зрелище
sigh – вздох
flap – возбуждение, тревога, беспокойство, паника; шлепать, хлопать, ударять
slather – намазывать, размазывать (smear); транжирить, расточать, тратить, расходовать в больших количествах (squander)
smear – намазывать, размазывать
squander – расточительство, расточать, проматывать, безрассудно тратить
harp – арфа, играть на арфе
harper – арфист (harpist)
decency – приличие, правила хорошего тона, порядочность
wrinkle – морщина, складка (crease) морщить(ся), мять(ся) (fold)
wrinkly – морщинистый, сморщенный, помятый
crease – складка, загиб, отутюженная стрелка
nope = nah = no – нет
kick, blow, knock = удар
trumpet – трубить, возвещать, рупор, труба, рожок (horn)
tripod – треногий, стул на 3-х ножках, тренога, штатив
chimp = chimpanzee – шимпанзе
explosion, detonation, burst = взрыв
explode – взрывать(ся) (burst)
splendid – роскошный, пышный, великолепный
churn – маслобойка, мешалка, миксер, смеситель, сбивать масло, перемешивать, взбалтывать
toll – звонить в колокол, колокольный звон
cesspool – выгребная яма, сточный колодец
lean – наклонять, нагибать, наклоняться, склоняться, прислонять, опирать, прислоняться, опираться
concern – интересоваться, волноваться, беспокоиться
lullaby – колыбельная (песня)
hushaby – баю-бай
off-key = фальшивый (о звуке)
snivel, snot – сопли
plenty – обилие, достаток, множество, избыток, масса
freshly – свежо, бодро
apparent – видимый, видный
apparently – по-видимому, видимо, вероятно, очевидно
carnage – резня, кровавая бойня, побоище (slaughter)
extermination – искоренение, уничтожение, истребление (destruction, extirpation)
wham – бить, ударять (strike, hit)
maggot – личинка
soy – соя, соевый боб, соевый соус (soy sauce)
sun block – солнцезащитный крем
shovel – лопата, совок, копать, рыть, вскапывать
tone – звук, тон, интонация
content – содержание, оглавление; удовлетворенность, довольный, удовлетворять (satisfaction, pleasure)
clang – лязг, звон, металлический звук, лязгать, бренчать, звенеть (clank)
dinosaur – динозавр
contrary – вопреки, наоборот
writhe – скручивать, сплетать, корчиться от боли
grudge – недовольство, злоба, зависть
spike – острый выступ, острие, шип, гвоздь, штырь, каблук, шпилька
lose – терять; пр.вр. – lost (Don’t lose my number)
passionate – пылкий, страстный
passion – страсть
triumph – триумф, победа, праздновать триумф, ликовать
earn – зарабатывать, заслуживать
prevail – доминировать, преобладать, господствовать
nefarious – нечестный, низкий, гнусный, мерзкий, подлый
strength – сила, сильная сторона
straight - прямой
adorable – обожаемый, милый, восхитительный
complicate – затруднять, осложнять, усложнять
soar – полет, парение, парить, высоко летать
snarl – рычать, огрызаться, рык, рычание
chant – петь, монотонно говорить, говорить с повторениями
blubber – громкий плач, рыдание, громко плакать, рыдать
