-------SP S12E01 - Tonsil Trouble
champ – чавкать, громко жевать (munch, chomp); чемпион – champion
contaminate – заражать, инфицировать (infect)
fluke – камбала
imply – подразумевать
botch – делать небрежно
blotch – клякса, пятно (чернил, краски) (blot)
transfusion – переливание
fusion – плавка; расплавление
towards – по отношению к
bravery – смелость
seriousness – серьезность
fraternity = frat = студенческое братство
smirk – ухмылка
rafter – балка
raft – плот
booby – болван, дурак; олуша – морская птица
tattle – болтовня, сплетни (gossip)
tattler – болтун
purposely – умышленно, намеренно, специально
appropriate – подходящий, соответствующий
inappropriate – негодный, неуместный, неподходящий
truce – перемирие
resistance – отпор, противодействие, сопротивление
resist - сопротивляться, оказывать сопротивление; противостоять
overcome – побороть, победить, преодолеть
afflict – беспокоить, страдать, задевать, огорчать (hurt)
accommodate – оказывать услугу
hinder – задерживать, затруднять, мешать, препятствовать (prevent, prohibit)
recede – отступать, пятиться
restrain – сдерживать, обуздывать, удерживать (subdue)
strain – натягивать, растягивать; напрягаться; переутомляться
altogether – в общем, в целом, всего
obstacle – помеха, преграда, препятствие
distill = distil – дистиллировать
trace – след, отпечаток, признаки, следы
-------SP S12E08 - The China Probrem
Olympic – олимпийский
Beijing – Пекин
performer – исполнитель, актер
perform – исполнять, выполнять
precision – точность (exactness , accuracy)
precious – драгоценный; большой ценности
advance – успех, прогресс, достижения (progress)
indecent – некрасивый, непривлекательный
outnumber – превосходить численно
tyranny – тирания, тиранство, деспотия (despotism); жестокость (cruelty, brutality, severity)
tolerance – терпимость
intolerance – нетерпимость
contemporary – сверсник, ровесник
temporary – временный
nomad – кочевник, бродяга (wanderer)
entrepreneur – предприниматель
lunch – обед
launch – начало (каких-л. действий)
belong – подходить, соответствовать, сочетаться
fellatio = blowjob
ejaculation – извержение, эякуляция
involvement – вовлеченность, участие
muck – навоз (dung, manure)
freak out – встревожить, взволновать
gig – выступление, концерт, мероприятие
district – район, область, округ
attorney – адвокат, юрист, прокурор (lawyer)
memorial – памятник, монумент, мемориал; памятный
prosecute – доводить до конца, завершать, выполнять, осуществлять
trial – судебное разбирательство, судебный процесс, суд
testify – давать показания, свидетельствовать
relieve – помогать, оказывать помощь (aid, assist, succor)
drip – капать, капанье
penetration – проникновение
intercourse – половые сношения, общественные связи или отношения
spank – хлопок, шлепок, хлопать, шлепать (slap)
squirt – струя
court – двор, суд
consumer – потребитель
traitor – предатель
squeal – визг, визжать (screech)
britches = breeches = buttocks – ягодицы
conscious – сознательный, осознанный, здравый
warrant – ордер, полномочия
warranty - гарантия; ручательство
sort out – улаживать (проблемы)
justice – справедливость, судья, правосудие
dignity – достоинство, гордость
ethical – этический
ethic = ethics – этика, мораль
ethnic – этнический
-------SP S12E09 - Breast Cancer Show Ever
spite – злоба, злость (malice); досаждать, донимать (annoy, irritate)
estimate – оценка, определение стоимости, оценивать, производить оценку, считать, полагать, расценивать
potty – горшочек; незначительный, несущественный, пустяковый
offensive = abusive = insulting = обидный, оскорбительный
constructive – творческий, конструктивный, строительный
dangerous = perilous – опасный, рискованный
testify – свидетельствовать, давать показания
remorse – угрызение совести, раскаяние, сожаление (pity, compassion)
desperate – безнадежный, бесперспективный, безысходный
find out = pry = worm out - узнать, разузнать
beware – беречься, остерегаться, опасаться
muscular – мускульный, мышечный, мускулистый
dystrophy – дистрофия
humble – скромный, робкий, застенчивый (modest, unassuming)
assume – принимать, брать на себя (ответственность, управление); вести себя самонадеянно
assuming – самонадеянный, высокомерный; если, при условии что
conscience – совесть
detention – задержание, арест; задержка
pare – срезать корку, кожуру, чистить, очищать, подрезать ногти
nerdy – непривлекательный, занудный, ботанического типа
weakling – слабый человек, неженка (sissy)
doozy – что-то необычное, удивительное
dodge – обман, уловка, хитрость, проделка (expedient); план, прием, способ (method, approach); увиливать, хитрить, ловчить (jink, evade)
rumor = rumour = слухи, молва
diagnose – ставить диагноз
diagnosis – диагноз
yea – да (утвердительный ответ, согласие)
-------SP S12E10 - Pandemic
mall – аллея для гуляния
tater = potato
neat – изящный
hose – шланг, поливать из шланга
cum = semen = sperm
bleep – короткий эл. звук вместо нецензурных слов
turn into – превращать во
all over – всюду, повсюду
fend – отражать, отгонять
integrity – нетронутость, неприкосновенность, целостность
fortunate – счастливый, удачный, благоприятный (favorable)
fortune – счастье, фортуна
ravage – губить, портить, разрушать
request – просить, обращаться с просьбой
internment – интернирование
intern, confine – заточать, держать взаперти, интернировать
patience – терпеливость, терпение
at all – совсем, полностью
vanish – исчезать, пропадать, исчезновение (disappearance)
influence – влияние, действие, воздействие, оказывать влияние, воздействовать
llama – лама (животное)
outdoor – вне стен учреждения
mate – спариваться, сочетаться браком
protect = defend
protector = defender
eradicate, extirpate – вырывать с корнем, искоренять
promenade – прогулка, гуляние, прогуливаться, гулять
relief – облегчение, рельеф
collective – коллектив, колхоз, групповой, совместный, общий
brief – короткий, недолгий; инструкции, задание, инструктировать, информировать, сводка, резюме, сведения
-------SP S12E11 - Pandemic 2 - The Startling
startle – испуг, страх, испугать, пугаться
pandemic – пандемия, пандемический
invest – инвестировать, вкладывать деньги
investment – инвестирование, капиталовложения, инвестиции
flute – флейта
lie – лежать, обманывать
Guinea pig – морская свинка
spooky – похожий на привидение, жуткий, страшный (terrible, frightful)
spook – привидение (ghost) пугать, нервировать, лишать спокойствия
dive – нырок, прыжок, нырять
diver – ныряльщик, водолаз
divert – направлять в другую сторону, переключать
contain – препятствовать (натиску врага), сдерживаться, владеть собой содержать в себе, включать, иметь в своем составе
reachable – достигаемый, достижимый
sew – зашивать, пришивать; вытекать, спускать воду
sewer – швец, швея; сточная труба, канализационная труба
prophecy – предсказание, пророчество (oracle)
panther – пантера, пума, барс, ягуар
outback – малонаселенная, необитаемая местность
stake – столб, кол, стойка, укреплять, подпирать
steak – кусок мяса/рыбы
palm – ладонь; пальма
footage – отснятый материал
hoard – запас, склад, скрытые запасы, запасать, копить (accumulate, amass, collect, gather)
horde – орда
hate = detest = abhor – ненавидеть, питать отвращение
foretell – предсказывать, прогнозировать (predict, prophesy)
oath – клятва, присяга (vow)
curse – проклятие (imprecation)
pirate – пират
sea-robber – морской разбойник, пират
rover – скиталец, бродяга, пират
robber – вор, грабитель
thief – вор, похититель
bandit – бандит, разбойник
marauder – мародер, грабитель
looter – вор
burglar – вор-взломщик
yegg – вор
pillager – мародер
prowler – вор
plunderer – вор, грабитель
spoliator – вор, грабитель
prevail – одержать победу, достигнуть цели, преобладать, господствовать
but – лишь, только
-------SP S12E12 - About Last Night...
democracy – демократия, власть народа
creed – кредо, мировоззрение, убеждения (credo)
confession – признание (вины, ошибки), раскаяние, покаяние, исповедь
spectacular – производящий глубокое впечатление, эффектный, впечатляющий
feat – подвиг (exploit, deed)
disperse – расходиться, рассеиваться (scatter), разбрасывать, раскидывать
flip – переворачивать, перекидывать, сальто flip the car
heist – воровство, грабеж, кража, ограбление (robbery, pillage)
enlighten – просвещать, обучать (educate, instruct), осведомлять, информировать (inform)
proof – подтверждение, доказательство, непроницаемый, непробиваемый
impenetrable – недостижимый, недоступный, неприступный
impenetrability – непроходимость, недоступность
penetration – проникание, проникновение
penetrate – проникать внутрь
breach – пролом, дыра; пробивать, проламывать (стену, оборону)
expense – затрата, расход, стоимость, цена, ценность
expensive – дорогой, дорогостоящий, ценный
underneath – под (below), вниз, внизу (beneath)
particular – редкий, особенный, специфический
distract – отвлекать (divert)
dig – копание, раскопки; жилье, берлога (lodging)
lodge – домик, сторожка у ворот, охотничий домик
drape – шторы, занавес
vault – свод, подвал, погреб, склеп со сводом, тайник
ark – ковчег
controversy – дебаты, спор, дискуссия, полемика (discussion, polemics, argument, debate, dispute)
relay – смена (рабочих), эстафета, реле, переключатель, заменять
bozo – тип, личность, субъект (fellow)
emit – излучать (физ.)
strive – стараться, бороться, прилагать усилия (try, exert, endeavor, attempt)
immediate – безотлагательный, незамедлительный, немедленный, неотложный (urgent, instant)
admit – признать (вину), признаваться, сознаваться (acknowledge, confess)
revise – проверять, исправлять, видоизменять, модифицировать, перерабатывать, пересматривать (amend, emend)
fake = sham = spurious = counterfeit = поддельный
shut off – выключать (воду, ток)
suspicious – подозрительный
decease – гибель, кончина (death, demise); почить, умереть (die, expire)
disease – болезнь
depart – отправляться, уходить, уезжать, покидать
overreact – слишком остро реагировать, принимать близко к сердцу
-------SP S12E13 - Elementary School Musical
reward – награда, премия, вознаграждение; награждать
inventory – инвентарь, список, реестр
audience – публика, зрители, радиослушатели, аудитория
gain – прибыль, выгода, извлекать пользу (profit)
appropriate – подходящий, соответствующий
claim – требование, претензия; требовать
comprehensive – всесторонний, полный, всеобъемлющий
promote – способствовать, содействовать, помогать, выдвигать, продвигать
uptight – встревоженный, взволнованный (alarmed)
sequel – продолжение (continuation)
sit back – откидываться на спинку стула, бездельничать
fuck off – уходить, переставать; пошел к черту!
back off – отодвигаться, отступать, освобождать поход
drive – доводить (до какого-л. состояния), приводить (к какому-л. состоянию) to drive to despair
sissy = cissy – баба (о мужчине), изнеженный мальчик, девчонка (о мальчике) (effeminate)
ease – облегчать (страдание), успокаивать, утешать (тревогу) (alleviate)
sit up – сидеть прямо, выпрямиться
posture – осанка
queer – гомосексуалист
fondly – доверчиво, наивно
recess – перерыв, каникулы, перемена (в школе)
mess around – лодырничать, дурачиться, валять дурака (fuck around)
hoop – обод, обруч, баскетбольное кольцо
outcast – изгнанник, изгой, отверженный (exile, castaway, pariah)
lisp – шепелявость, шепелявить
abuse – оскорбление, брань (insult) 
by all means – конечно, пожалуйста
audition – выслушивание, слушание, слух, проба, прослушивание
strum – бренчание, бренчать (на гитаре)
fiddle – скрипка (violin)
cave in – уступать, отступать, сдаваться
bail – заклад, залог, поручительство
-------SP S12E14 - The Ungroundable
tempt – соблазнять, искушать (charm, captivate, allure, attract, entice, lure, seduce)
temptation – искушение, соблазн, приманка (bait, lure)
famine – голод, голодание (starvation, hunger)
fictional – вымышленный
fiction – выдумка
impersonate – подражать (кому-л.), перенимать (чьи-л. манеры, речь) (imitate)
personate – играть роль, выдавать себя за кого-л.
coarse – грубый (rough, rude, vulgar, uncivil)
refine – очищать (от примесей), рафинировать
clarification – прояснение, ясность (мыслей, ума, рассудка)
clarify – сделать понятным, ясным; проливать свет (на что-л.); (explain, elucidate)
flak – зенитная артиллерия
rank – звание, чин, категория, класс, разряд, ранг
fang – клык
tusk – бивень, клык
dusk – сумерки
intention – намерение, стремление, цель (purpose, intent, aim, goal)
outta = out of
hangout – постоянное место сборищ
hideout – укрытие, пристанище, убежище (cover, shelter)
solace – утешение (comfort, consolation); утешать, успокаивать (comfort, console)
sangui- = крово-, крове-
rely – надеяться, быть уверенным, доверять
relay – реле, переключатель
chalice – церковная чаша
trail – след, тропа, тропинка, прокладывать путь
compel – заставлять, вынуждать (constrain, oblige), принуждать, подчинять, покорять
negligence – небрежность, невнимательность, халатность, неряшливость
per se - само по себе; по сути, непосредственно
blurt – проговариваться, сболтнуть, выпалить (blab, leak - течь, протечка; утечка)
Goth – гот
wannabees – поклонницы, поклонники
count – 1. вычисление, подсчет 2. граф
pantry – кладовая для продуктов
preoccupation – невнимательность, озабоченность, рассеянность
holler – кричать, орать
repose – отдых, передышка, сон, покой, спокойствие
Vigil – ночная служба (церк.)
keen – острый (sharp)
scarce – недостаточный, скудный (scanty, insufficient, deficient), редкий, дефицитный
scarcely – едва, почти не, едва ли, с трудом (only, just, hardly)
seek – искать, разыскивать (look for)
thus – так, таким образом, соответственно
bidding – приказ, приказание, распоряжение; аукцион, торги (auction)
thy – твой, твоя, твоё, твои
thou – ты
opportunity – шанс, возможность (chance, occasion, break)
twerp – идиот, дурачок, простофиля
boor – грубиян, хам
prep – подготовительный, начальный; готовить; подготовка
preppy = preppie - учащийся подготовительной школы
slumber – сон, дремота; спать, дремать (sleep, doze, drowse)
fad – прихоть, причуда, фантазия, конек
fashion = vogue – мода
flipping – проклятый! (cursed, damned)
flip – переворачивать, перекидывать; щелкать, хлестать; подбрасывать
trend – курс, направление, тенденция
distraction – беспорядок, раздоры, то что отвлекает внимание, отвлечение внимания
minion – любимец, фаворит, кумир (favorite, idol)
spiritual – духовный
injection – инъекция, вливание, впрыскивание
inject – впрыскивать
refer – говорить, упоминать, обмолвиться, ссылаться, опираться
reference – связь, отношение, касательство (relation); ссылка, упоминание
midget – карлик, лилипут (dwarf, pygmy = pigmy)
pock – выбоина, вмятина, ямка, углубление (dent, dint)
spit – плевок, слюна, мокрота (saliva, spittle, sputum)
hickey – покраснение, след от поцелуя, засос (love-bite)
widget = gadget = gizmo - штука, штуковина, вещица
clammy – клейкий, липкий, вязкий (sticky, adhesive, viscous)
dusk – сумерки, сумрак (twilight)
hesitate – колебаться, сомневаться, не решаться (vacillate)
wank – заниматься мастурбацией
wonk – ботан
and so on – и так далее
generalization – обобщение
apparent – видный, очевидный, открытый, несомненный (evident, obvious)
apparently – очевидно, видимо (evidently)
identity – особенность, отличительная черта (peculiarity) national identity — национальные особенности
identify - опознавать, распознавать; устанавливать личность
endless – бесконечный, бесчисленный (eternal, infinite)
brag – хвастаться, хвастун, хвастливый человек (boast)
miserable – плохой, убогий, скудный (качество)
snuck = sneaked – пр. вр. от sneak
behave – вести себя, поступать, держаться
lair – берлога, логовище (den)
assembly – сбор, собрание, сходка; сборочный
abundantly – достаточно, полно, чрезмерно, щедро
abundant - обильный, богатый, изобилующий
occult – сокровенный, тайный, скрытый, не видимый; прятать, скрывать (eclipse – затмение, заслонять)
boner – промах, просчет, глупая ошибка
-------SP S13E02 - The Coon
coon = raccoon – енот
plummet – кидать, бросать, швырять вниз (грузило)
intact – нетронутый, незатронутый
identity – личность, подлинность
hassle – барьер, преграда, препятствие
disarray = disorder – беспорядок
county – графство, округ
reckless – необдуманный, опрометчивый
reck – обращать внимание, беспокоиться
vigilante – член “комитета бдительности”
proof – доказательство, подтверждение
dilapidate – разрушать, ломать
copycat – подражатель (imitator)
idle – бесполезный
arbitrary – произвольный, случайный
token – знак, символ
aftermath – последствия
yay! – выражает триумф, одобрение
confession – исповедь
rally – съезд, слет, митинг
binocular – бинокль
cloak – плащ, мантия
glimpse – бегло взглянуть, увидеть мельком
harass – беспокоить, волновать (bother)
Godspeed! – пожелание удачи
bleak – суровый, жестокий (grim)
dreary – грустный, печальный, унылый (sad)
[costume = dress = suit]
wretch – негодяй, негодник (scoundrel, rascal, rogue)
underbelly – низ живота, уязвимое место
resort – посещать, прибегать к
utterly – весьма, крайне, черезвычайно (extremely)
delightful – восхитительный, очаровательный (adorable)
scum – пена, отбросы, мразь
scumbag – падонок
headquarter – штаб-квартира
minion – любимец, кумир
coke – кокаин, Coca-Cola
sprite – эльф, фея (fairy)
tick – галочка, тикать
threaten – грозить, угрожать
consequence – последствия, результат (result)
reveal – открывать, разоблачать
precious – драгоценный (дорогой, любимый)
undoing – гибель
villain – злодей, негодяй
scrotum – мошонка
inhabitant – житель (resident)
bubba – братишка
beloved – возлюбленный
forced – вынужденный
waffle – вафля (пустая болтовня, треп)
mull – обдумывать, размышлять
urchin – еж (hedgehog)
exhausted – обесслиленный, изнуренный
inclusive – включающий, содержащий
presume – предпологать
nay - 1) отрицательный ответ; отказ; запрещение
-------SP S13E07 - Fatbeard
swashbuckling – хулиганский
high sea – открытое море
admire – любоваться
booty – трофеи (попа)
plunder – трофеи
oasis – оазис
inform – сообщать, информировать, уведомлять
chore – рутинная работа, работа по дому
ahoy – на палубе! На корабле!
boredom – скука, тоска
attention – смирно!
lubber – неуклюжий, неопытный моряк
small talk – светский разговор
lad – юноша
farewell – прощальный
await – ждать (wait, expect)
landlubber – сухопутный житель
lass – девушка (girl)
beyond – по ту сторону
counter – прилавок (счетчик)
lagoon – лагуна
ransom – выкуп
commandeer – конфисковать
marsh – болото, топь (swamp)
vessel – корабль (сосуд)
meagre = meager – скудный, тощий, чахлый
aft – в кормовой части корабля
starboard – право руля!
hearty – сердечный, здоровый, моряк
renegade – бунтарь, мятежник
port – левый борт (гавань, порт)
scallywag – шалопай = scalawag
lest – что бы не, как бы не
bow – гнуть, дуга, лук, радуга, нос корабля
for sure – конечно!
monotony – монотонность, скука (boredom)
unharmed – невредимый
unpunished – безнаказанный
eater – едок
lifeboat – спасательная шлюпка
swarm – толпиться, кишеть, рой, стая, толпа
lower – спускать, опускать
scoundrel – негодяй, мерзавец
topside – на палубе (лицевая сторона, верхняя поверхность)
grog – грог (напиток)
Dixie – южные штаты США
beat-up – потрепанный, побитый
[do as you please]
pillage – грабить, мародерствовать
squall – шквал
spree – шалости, кутеж (frolic, binge)
decree – директива, постановление
afloat – на плаву
glee – веселье, ликование
enunciate – ясно, отчетливо произносить
flat – фальшивый (о звуке)
bar – тактовая черта
cove = cave – пещера
crock – глиняный горшок (jar, pot)
adrift – дрейфующий
sabre = saber – сабля
navy – военно-морской флот, флотилия
deploy – разворачивать, развертывать (войска)
stand-off – безвыходное положение, тупик
necklace – ожерелье, ошейник
holler – кричать, орать
plank – планка
scurvy – презренный, жалкий
hardship – трудности
suffering – страдания
outfit – подразделение
-------SP S13E10 - W.T.F.
ample - 3) просторный; обширный All assembled in the ample kitchen. — Все собрались в просторной кухне.
settle - 3) решить, принять решение to settle on a name for the baby — выбрать имя для новорожденного
rad - от radical классный, крутой Syn: cool
hold - 6) клинч, захват (в борьбе, боксе, дзю-до) to break a hold — снять захват
molester - molester 1) лицо, докучающее, досаждающее кому-л. 2) лицо, пристающее к прохожему, к женщине; хулиган 3) лицо, покушающееся на растление (малолетнего)
takedown - 3) захват (приём в борьбе)
charge - 14) атаковать (особенно в конном строю) ; нападать, атаковать, набрасываться; напирать, наседать to charge at smb. — нападать на кого-л. to charge into — врываться
referee - 2) рефери, судья Hey, ref, get some glasses! — Судью на мыло! The ref did a fine job — Судейство было отличное
yup – да
claw - 1) коготь Syn: talon
geez = jeez
naw - variant spelling of no , used to answer a question
forfeit - 1) поплатиться чем-л.; проиграть, лишиться чего-л. He forfeited the game to his opponent. — Он проиграл игру противнику.
hepatitis - гепатит, воспаление печени infectious hepatitis — инфекционный гепатит acute viral hepatitis — вирусный гепатит
turnout - б) аудитория, публика (те, кто собираются) There was a large turnout for the game / for the rally. — На матч / митинг пришло много народу.
lo = lo and behold! вот!, слушай!, смотри!
discontent - недовольство; неудовлетворённость, неудовольствие, досада outspoken discontent — высказанное неудовольствие widespread discontent — широкое недовольство to stir up / cause discontent — вызывать недовольство
sewage - сточные воды; нечистоты
terminate - 3) увольнять
board - правление, руководство, совет, коллегия - board of directors - school board
involve - а) привлекать, вовлекать, втягивать to involve smb. in a project — вовлекать кого-л. в проект
discontinue - 1) прекращать, останавливать, прерывать to discontinue a magazine — прекратить подписываться на журнал
intermission - 1) прерывание, задержка, остановка Syn: interruption , stop 2) а) пауза, перерыв б) антракт в) перемена Syn: break, interlude 3) сбой, остановка (сердца, пульса)
flub - испортить, завалить, провалить, запороть (какое-л. дело) He flubbed the performance. — Он провалил представление. Syn: botch, bungle
grease - 2) пачкать, марать, загрязнять а) топлёное сало; жир spot of grease — жирное пятно
retriever = hound
inmate - б) заключённый (в тюрьме, лагере) в) пациент стационара
-------SP S13E14 - Pee
slide - 4) а) дорожка с залитым льдом; каток б) ледяная горка 5) спускной жёлоб; наклонная плоскость
dope - модный, стильный; клёвый, классный, крутой
lapping - всплеск, плеск Syn: swash , plash
authority - а) обычно authorities (органы) власти to invoke authority — взывать к властям
priority - 1) первенство, преимущество, приоритет, старшинство to establish / set a priority — расставить приоритеты, определить систему ценностей to reexamin / rethink priority — пересмотреть систему ценностей to reorder / sort out one's priorities — изменить приоритеты
you bet! — конечно!; ещё бы!; будьте уверены!
most likely, very likely вероятно
whoop - 1) возглас, восклицание whoops of victory — победные крики to emit / let out a whoop — издать возглас, восклицание
dire - 1) страшный, ужасный, жуткий; внушающий ужас; предвещающий несчастье dire consequences — печальные последствия Syn: dreadful 1., evil 2., horrible 1., mournful , terrible
barge - б) врываться (в помещение) He barged into the room. — Он ворвался в комнату.
breach - 4) волны, разбивающиеся о берег или о судно; 1) брешь, пролом, дыра; повреждение to effect / make a breach (in enemy lines) — пробить брешь (в рядах неприятеля)
exposed - незащищённый, уязвимый, беззащитный - exposed to the wind Syn: unprotected , defenceless , undefended , unguarded , defenseless , unshielded
meltdown - 2) катастрофа; крах; провал; банкротство financial meltdown — финансовый крах; банкротство
neutralize - 4) нейтрализовать
ramification - 4) (ramifications) последствия, результат ramifications of a crisis — последствия кризиса
ben - в, внутрь ben the house — в дом, внутрь дома Syn: in, into
claim - 2) заявлять, утверждать He claimed that he'd been cheated. — Он заявил, что его одурачили.
agitate - 1) волновать; возбуждать You are alarmed and agitated by the lamentations of those ladies. — Вы встревожены и взволнованы жалобами тех леди. 2) агитировать More people are agitating for improvements in prison conditions. — Всё больше людей призывает улучшить условия содержания в тюрьмах.
-------SP1402 The Tale of Scrotie McBoogerballs
risque - рискованный; непристойный, сомнительный (об остроте, шутке, истории и т.п.)
kook - 1) чудик, ненормальный Syn: nut 1., screwball
entice - 1) соблазнять It is wicked to entice a man from his family. — Нехорошо соблазнять мужчину, у которого есть семья. Syn: lure 2., tempt , seduce
obscene - а) непристойный, непотребный; грязный; порнографический obscene videos — порнографические видеокассеты obscene jokes — непристойные шутки Syn: indecent , outrageous , pornographic
vivid - 1) яркий vivid glow — яркое зарево vivid flash of lightning — яркая вспышка молнии Syn: bright , blazing
vag = vagina
sleepwalking - лунатизм, сомнамбулизм Syn: noctambulism , somnambulism
blackout - 2) засекреченный
angst - 1) страх, экзистенциальная тревога 2) тревога, беспокойство, боязнь; страх teenage angst — подростковый страх mummy-angst novel — роман о вечно обеспокоенной мамаше
literary - 1) литературный
fragile - а) ломкий, хрупкий Syn: brittle , friable
brood - 2) размышлять; вынашивать (в уме, в душе) It's no good brooding about your troubles. — Вредно всё время думать о своих проблемах.
nonetheless - несмотря на, однако
nevertheless - всё же, всё-таки, тем не менее It will come to pass nevertheless. — Это всё-таки произойдёт.
smut - 3) непристойность, непристойное выражение; вульгарный язык Syn: obscenity
arbitrarily - 1) без достаточных оснований, произвольно; своевольно
oppression - 1) гнёт, иго, притеснение, угнетение Syn: depression , press , pressure , weight , burden
liberal - 1) свободомыслящий, с широкими взглядами, без предрассудков She is known to have liberal views on divorce and contraception. — Известно, что она без всяких предрассудков относится к разводу и применению противозачаточных средств. Syn: broad-minded
acclaim - шумное приветствие (applause)
raunchy - 1) грязный, неряшливый 2) а) грязный, похабный б) сексуальный Syn: sexual
festive - весёлый, праздничный, радостный Syn: festal , holiday
squat - а) сидеть на корточках
platter - 1) большое плоское блюдо
pro-life - являющийся сторонником запрещения абортов
pro- - 1) про- (образует слова со значением "сторонник")
reel - покачнуться, пошатнуться (от удара, потрясения и т.п.) The fighter reeled back when the heavy blow landed unexpectedly on his chin. — Боксёр зашатался от неожиданного сильного удара в подбородок.
-------SP1403 Medicinal Fried Chicken
medicinal - лекарственный; целебный medicinal agent — лекарственное средство Syn: officinal 1), curative
drill - 1) подготовка, тренировка; упражнения, отработка (чего-л.) ; зубрежка drill book — сборник упражнений to conduct a drill — проводить тренировку
shifty - 2) хитрый; нечестный shifty evasions — хитрые уловки Syn: dishonest
agitate - 1) волновать; возбуждать
dispensary - 1) пункт раздачи бесплатных лекарств 2) благотворительная аптека для бедных 3) благотворительный медицинский пункт; бесплатная амбулатория; бесплатный диспансер
openly - 1) открыто, публично Syn: publicly 2) откровенно, прямо Syn: frankly , candidly , unreservedly
reference - 2) справка; справочная информация - book of reference - reference library - reference room
referral - направление (на работу, к врачу и т.п.) to make a referral — выдать направление
qualify - в) зарабатывать, заслуживать If that boy goes on behaving like that, he'll qualify for severe punishment. — Если этот мальчик и дальше будет вести себя так, он заработает суровое наказание. (deserve)
chemo = chemotherapy – химиотерапия
induce - 2) вызывать; стимулировать; приводить (к чему-л.) Syn: bring on , cause 2., produce
to take it easy - 1) не волнуйся! 2) смотри на вещи проще!
low-income - с низким доходом, низкодоходный low-income worker — работник с низким доходом low-income family — семья с низким доходом low-income industry — низкодоходная отрасль
gravy - 1) подливка (из сока жаркого) , соус, сок
colon - ободочная кишка, толстая кишка
preservative - 2) консервант
preservation - 3) консервирование food preservation methods — методы консервирования продуктов Syn: preserving
preserve - 2) охотничий или рыболовный заповедник; заказник forest preserve — лесной заповедник
exposure - а) подвергание (какому-л. воздействию) ; выставление, оставление (на солнце, под дождём) Exposure to lead is known to damage the brains of young children. — Известно, что воздействие свинца разрушает клетки головного мозга у маленьких детей.
score - 7) удача what a score! — повезло!
buffalo - 1) буйвол
bust = arrest
they say = it is rumoured - говорят They say it's a small world. — Говорят, мир тесен.
biz = business
arrangement - 2) договорённость, соглашение - come to an arrangement
bulk - 1) груда, кипа; масса (heap , mass)
informant - информант; осведомитель; доносчик
to get lost - 1) заблудиться 2) перестать надоедать (кому-л.) I don't want to hear any more, get lost! — Я не хочу ничего больше слышать, отстань! 3) , обламываться get lost! — обломись!
in charge - 1) заведующий 2) дежурный The officer in charge was wounded. — Дежурный офицер был ранен.
bill - 3) законопроект, билль (вносимый на рассмотрение законодательных органов)
abuse - 3) злоупотребление abuse of power — злоупотребление властью alcohol abuse — злоупотребление алкоголем drug abuse — употребление наркотиков drug of abuse — наркотик 4) неправильное употребление, использование abuse of words — неправильное или необычное употребление слов abuses of figures — подтасовка статистических данных
UN - от United Nations (the UN) ООН, Организация Объединённых Наций
repeal - 1) аннулировать, отменять (закон, резолюцию, приговор и т.п.) (void)
relieve - а) облегчать, ослаблять, уменьшать
relief - 1) облегчение, утешение (comfort , relaxation , ease , alleviation)
prosthetic - 1) протетический, относящийся к протезе 2) протезный
-------SP1404 You Have 0 Friends
stock - в) доля акций, акции 1) запас to lay in stock — делать запасы 2) ассортимент (товаров)
plummet - 1) кидать, бросать, швырять вниз (с силой) ; сбивать (птицу, самолёт) Syn: hurl down 2) = plummet down быстро и отвесно падать The prices are plummeting (down). — Цены стремительно падают. а) строительный отвес; гирька отвеса б) грузило, грузик (на удочке, рыболовной сети) в) лот г) висячий маятник (в метрономе)
merger - 2) слияние, объединение (коммерческое, промышленное)
steer clear of - take care to avoid or keep away from steer clear of fatty food
fertilize - 1) удобрять, обогащать почву, вносить удобрение to fertilize soil — удобрять почву Syn: enrich 2) обогащать; усиливать to fertilize intellect — обогащать ум 3) оплодотворять; опылять
as long as - пока; до тех пор, пока
liability - 4) помеха; источник неприятностей; обуза Opinion polls show him to be a liability to the Labour Party. — Опросы общественного мнения показывают, что он стал обузой для партии лейбористов. He should go because he has become a liability. — Он должен уйти, так как стал обузой. Employers saw her age as a liability rather than an asset. — Работодателям её возраст казался помехой, а не ценным качеством. Syn: hindrance , drawback
hindrance - барьер, помеха, преграда, препятствие She is more of a hindrance than a help. — Она больше мешает, чем помогает. The high price is a major hindrance to potential buyers. — Высокая цена - основное препятствие для потенциальных покупателей. Syn: obstacle , impediment
liability - а) обязательство, ответственность to accept / acknowledge / assume / incur / take on a liability — принимать (на себя), нести ответственность (responsibility , amenability)
roulette - 1) рулетка (азартная игра) to play roulette — играть в рулетку
wade - 3) (wade through) преодолевать to wade through a dull book — с трудом осилить скучную книгу to wade through innumerable details — разобраться в бесчисленных подробностях
wade - 1) переход вброд, преодоление брода wade in the brook — переход вброд через ручей 2) брод Syn: ford
commence = begin
commodity - 1) предмет потребления
flush - флеш (в покере - все или несколько карт одной масти)
flush - 4) вспыхнуть, (по)краснеть; заставлять краснеть, смущать (кого-л.) Syn: redden , blush
rogue - 2) не поддающийся контролю, неконтролируемый rogue firm — незарегистрированная фирма
circuitry - график, диаграмма, схема
circuit - 15) цепь, контур; схема
