--------- The Simpsons 19x01 - He Loves to Fly and He D'ohs
hoodlum – хулиган
penny = cent = 0.01 $
arouse – пробуждать, вызывать, возбуждать (чувства, страсти, энергию, интерес)
refuse, reject = отвергать, отказывать, отклонять
extractor = извлекающее устройство, щипцы, соковыжималка
premise, premiss = помещение, дом
applaud = аплодировать, хлопать, рукоплескать (clap – хлопать, plaudit, applause, clapping - аплодисменты)
yawn – зевать, зевок
shrink – уменьшать, сокращать, высыхать, сморщиваться; психиатр
therapist – врач (невропатолог, психиатр)
counsel – давать совет, советовать (advise, consult)
counselor – советник, консультант
insist – настойчиво требовать, настаивать на
relish – соус (sauce) гарнир (garnish) закуска (appetizer)
behold – видеть, замечать, пристально смотреть, рассматривать
average – средняя величина, среднее число
weep – плакать, рыдать (blubber, cry, sob, wail, whimper)
alley – аллея, узкая улица
confident – уверенный, самоуверенный
urine – моча
stat – без промедления (immediately), немедленно, незамедлительно
CEO = Chief Executive Officer
truck – дешевый розничный товар, хлам, ненужные вещи; грузовой автомобиль, грузовик
pepper – перец, перчить, посыпать перцем; усыпать, забрасывать вопросами
delight – удовольствие, наслаждение, предмет восхищения, радовать, восхищать
frank – откровенный, искрений (candid)
fudge – сливочная помадка; ложь, обман (deceit, deception)
capability – одаренность, талантливость, способность (capacity)
cliff – пропасть, обрыв
bub = bubby – мальчик, парень, паренек; женская грудь, титька; сосок (teat, bosom, breast, boob, bubby)
FAA = Federal Aviation Agency
retire – отдых, уходить, оставлять компанию, уходить в отставку, ложиться спать, выходить на пенсию, на заслуженный отдых
elevation – высота (height)
income – доход, прибыль, заработок
exclamation – восклицание (mark of exclamation)
--------- The Simpsons 19x02 - Homer of Seville
brunch – поздний завтрак
griddle – сковорода, протвинь
slay – убивать (kill)
slayer – убийца (killer, assassin)
buffet – буфет для посуды, буфет-стойка, шведский стол, фуршет
haricot – фасоль (bean)
vert - зелень, растительность
heirloom – фамильный вещи, фамильная ценность
loom – ткацкий станок
heir – наследник
cater – обеспечивать, обслуживать (provide, service)
catering – поставка, снабжение
classy – отличный, классный, изящный
class – классный, шикарный
gravy – подливка
slather – намазывать, размазывать (smear)
corpse – труп (cadaver, dead body)
mahogany – красное дерево
casket – шкатулка, гроб, сокровищница
quiche – пирог
cease – переставать, прекращать(ся) (stop)
pall – мантия, покров (на гробе, могиле)
mild – легкий, неострый (о болезни, приступе) неострый, некрепкий (о еде, напитках)
sprain – растяжение связок, сустава, вывихнуть, растянуть (wrench)
ingest – глотать, проглатывать (swallow, gulp)
vertebra – позвоночник
fascinate – восхищать, приводить в восторг
fascinating – обворожительный, очаровательный
lodge – квартировать, временно проживать
diaphragm – диафрагма; противозачаточный резиновый колпачок
uterus – матка (анат.)
alleviate – облегчать (боль, страдание), смягчать
lessen – уменьшать, сокращать
streak – полоска, жилка, прожилка
streaked – с полосками, с прожилками
luster = luster – глянец, блеск, отражать свет; люстра
nip – осколок, обломок, фрагмент, укус, щипок, щепотка
morgue – морг, покойницкая (mortuary)
contribute – делать пожертвование, взносы, вносить вклад в (науку) содействовать, способствовать
praise – по(хвала), восхваление, хвалить, восхвалять
entourage – окружение, окружающая обстановка, свита (escort)
flirt – кокетка, флиртовать, кокетничать, заигрывать
yoko – женщина которая мешает дружбе
deluxe – богатый, дорогой, пышный, роскошный, шикарный
groupie – поклонница
acquire – получать, приобретать, овладевать навыком (get)
twilight – сумерки, полумрак, сумрак (dusk)
belong – подходить, соответствовать, сочетаться, принадлежать, быть чьей-то собственностью
former – бывший, давний, старый, предшествующий, упомянутый выше
disgruntle – сердиться, досаждать, раздражать (annoy, vex, anger)
lockdown – строгая изоляция
gargoyle – горгулья
sharpshooter – снайпер (sniper)
inflatable – надувной
decoy – приманка (lure, bait)
decay - гнить, разлагаться
threat – опасность, угроза (danger)
threaten, menace – грозить, угрожать
chandelier – люстра
foil – фольга
chop – кусок мяса, отбивная, отрезать, отрубать, рубить
conductor – дирижер, проводник, кондуктор
dart – стрела, копье, дротик, бросать, метать
addict – наркоман, заядлый любитель чего-л.
--------- The Simpsons 19x03 - Midnight Towboy
clingy – липкий, клейкий, прилипчивый, цепкий (sticky)
cling – цепляться, держаться, крепко держаться
spill – проливать, разливать, расплескивать
eggshell – яичная скорлупа, бледно-желтый цвет
ivory – слоновая кость, цвет слоновой кости
infant – младенец, ребенок до 7 лет (child, baby)
diner – вагон-ресторан, закусочная построенная по такому типу
crotch – промежность (perineum)
tow – буксирный канат, буксир, буксировка, тянуть, буксировать
impound – конфисковать (confiscate, seize)
vast – простор, просторный, безбрежный
invoke – простить, умолять, упрашивать
frustrate – разочаровывать (disappoint)
lasso – аркан, ловить арканом
cattle – крупный, рогатый скот
miserable – жалкий, несчастный (sorry, unhappy)
jockey – жокей, оператор, механик (operator)
silhouette – силуэт
haunt – неотступно преследовать, ходить хвостом, не давать покоя (о мыслях)
turf – дерн, искусственный дерн, торф, контролируемая территория, сфера влияния
shove – пихать, толкать, вталкивать, совать, засовывать
allude – упоминать, ссылаться (mention)
handicap – физический или умственный недостаток
cab – такси
nurture – воспитание, обучение, обучать; питание, пища, кормить
veto = forbid = prohibit
reinforce – укреплять, усиливать
allow = permit – позволять, разрешать
permission – позволение, разрешение
actualize – осуществлять, выполнять, реализовывать
brake – тормоз, тормозить
hover – парить (о птице), неподвижно зависать в воздухе (о вертолете), нависать (об угрозе, облаках, тучах)
domain – территория, зона, область, район
dough – тесто, деньги
dispute – диспут, дискуссия, дебаты, полемика, спорить, оспаривать
sense – чувство, ощущение
sensibility – чувствительность
sensitiveness – чувствительность
sensitive – чувствительный, сенсорный
insensitive – нечувствительный, равнодушный
bully – задира, забияка
winch – лебедка, поднимать с помощью лебедки
mayor – мэр
major – майор
comprehend – понимать (understand)
comprehensible – понятный
comprehensibility – понятность
greed = жадность, скупость
greedy – жадный
braid – коса (волос), плести (weave, plait)
regulate = control = govern – управлять
luggage = baggage – багаж
avast – стой! стоп!
ye = you = ya
hilarious – веселый, шумный, оживленный (gay, merry)
medieval – средневековый
swear – клятва, богохульство, ругательство
plateau – плато, плоскогорье, плоская возвышенность
determine – решать (decide, resolve, solve)
--------- The Simpsons 19x04 - I Don't Wanna Know Why the Caged Bird Sings
deposit – депозит, вклад (в банке)
insure – страховать(ся), застраховать(ся) (ensure)
receive = acquire = get – получать, приобретать
fair – базар, рынок, ярмарка; красивый, прекрасный, красиво, прекрасно
coffin – гроб (grave)
conduct – сопровождать, дирижировать, вести себя (о манере, поведении)
mock – поддельный, фальшивый (pretended)
sober – трезвый
gawk – простофиля, остолоп, разиня, смотреть с тупым видом, таращить глаза
scam – афера, жульничество
darn – проклятый (damn, cursed)
queue = line – очередь
although – хотя; не смотря на то, что
transaction – дело, сделка, соглашение
unfit – негодный, неподходящий, непригодный
fit – подходящий, годный, пригодный
polish – глянец, блеск (luster, shine) натирание, полировка, шлифовка, натирать, полировать, шлифовать
remain – оставаться, оставаться в каком-либо состоянии
above all – прежде всего
stake – столб, кол, подпирать, финансировать, поддерживать
dye – краска, краситель, красить, окрашивать
sting – жало, жалить, жечь, кусаться
surrender – сдавать(ся), капитулировать, поддаваться, отказ (от чего-л.)
surround – окружать, обступать
transition – перемещение, переход, переходный период
owe – быть обязанным, быть должным
tavern – таверна, бар, закусочная (snack bar, lunchroom)
excuse – оправдание, причина, отговорка, предлог, сожаление, извинение, извиняться
frisk – обыскивать (в поисках оружия); скакать, прыгать, прыжок, скачок
keister – задница (keester)
needy – бедный, бедствующий, нуждающийся
penniless – без гроша, бедный, безденежный
bug-eyed – пучеглазый, с глазами на выкате
amusement – развлечение, увеселение, забава
diversion – приятное время провождение
entertainment – вечеринка, зрелищное мероприятие
pastime – приятное время провождение, забава (hobby)
caricature – карикатура (cartoon, parody, mimicry, travesty)
harsh – жесткий, суровый, грубый (severe, cruel, tough, rude)
filament – нить накала, волокно, волосок (fibre = fiber)
sturdy – прочный, крепкий, выносливый (strong, stout)
urge – побуждение, толчок, подгонять, подгонять, убеждать, советовать
outlaw – лишать законной силы, объявлять незаконным, беззаконный, незаконный, объявлять вне закона
crossbow – арбалет, самострел (arbalest, cross-bow)
elk – лось
davenport – диван-кровать (couch, sofa)
cooker = stove = range – плита, печь
crook – крючок, крюк, сгибать, искривлять (bend, curve) скрючиваться, изгибаться, извиваться
scorch – ожог, след от ожога, обжигать, выжигать, сжигать дотла (burn)
stool – табурет, скамеечка
jolt – толчок, соударение, столкновение, тряска, встряхивать, трясти (shake)
goo – что-л. липкое, клейкое, вязкое
boil – нарыв, фурункул
wart – бородавка
penitentiary – исправительный дом, каторжная тюрьма
mental – интеллектуальный, умственный, производимый в уме, мысленный, психический
allure – вовлекать, втягивать, завлекать, приманивать, очаровывать (lure, entice – соблазнять decoy, inveigle - заманивать)
slug – слизень, слизняк; медленно передвигать ноги, волочить ноги, тунеядец, лентяй; сильный удар кулаком (blow) сильно ударять, бить (beat, thrash = thresh)
slugger – сильный отбивающий игрок в бейсболе
pole – столб, шест, кол; полюс
disgrace – позор (shame) бесчестье, унижение, позорить, бесчестить (dishonour = dishonor, discredit)
convict – отбывающий наказание, заключенный, каторжник
escapee – беглец (fugitive, runaway, jail-breaker)
tiptoe – кончики пальцев, цыпочки, ходить на цыпочках, красться, подкрадываться
plaster – штукатурка; пластырь; штукатурить, накладывать пластырь
terrify – ужасать, внушать ужас, запугивать (frighten, scare)
carnival – карнавал, фестиваль, ярмарка аттракционами

unselfish – бескорыстный, неэгоистический
carve – резать, вырезать, гравировать, высекать
though – тем не менее, однако, все-таки
--------- The Simpsons 19x05 - Treehouse of Horror XVIII
gory – окровавленный, запачканный забрызганный кровью (bloody)
fair – честный, справедливый, базар, ярмарка
burnt – горелый, жженый
caramel – карамель, жженый сахар
caramel, caramelize – карамелизовать
shed – навес, сарай
butane – бутан (хим.)
glow – свет, отблеск, зарево, светиться, сверкать, озарять (shine, blaze)
unearthly – неземной, сверхъестественный, загадочный
testicle – яичко (анатом.)
vulnerable – уязвимый, ранимый
vulnerability – уязвимость, ранимость, слабые места в системе защиты
shore – берег, крепление, подпора, опора, поддерживать, подпирать (support) оказывать поддержку, укреплять
ray – луч, скат (рыба)
applicator – мед. инструмент для введение в полость лечебного средства
sergeant – сержант (звание)
insufficient – недостаточный, неподходящий, неудовлетворительный, несоответствующий (scanty – недостаточный, скудный, ограниченный)
sufficient – достаточный, обоснованный
phonic – акустический, звуковой (acoustic) голосовой (vocal)
dealer – агент по продажам
dissect – анатомировать вскрывать (anatomize) анализировать
sect – секта, партия, фракция
dupe – дубликат, копия (duplicate)
sage – шалфей, полынь (ботан.) мудрец
uranium – уран (хим.)
weld – сварной шов, сварка, сваривать(ся)
tighten – сжимать(ся), натягивать(ся), затягивать(ся), уплотнять
wrench – гаечный ключ, вывихнуть, растянуть, вывих
wench – девица, девушка, молодая женщина
loyalty – верность, преданность, лояльность
pest – надоедливый человек, вредитель, паразит (с/х)
observant – внимательный, наблюдательный, приметливый
observe - наблюдать, замечать, обращать внимание
missile – ракета, реактивный снаряд, реактивный, ракетный (rocket , jet)
facility – оборудование, приспособления, аппаратура, здания (заводов, фабрик)
tentacle – щупальце, усик
elsewhere - где-то в другом месте; куда-то в другое место
harbor = harbour – гавань, порт (haven, port); прибежище, пристанище, убежище, укрытие, утаивать, скрывать, дать убежище (refuge, haven, shelter)
decent – приличный, порядочный, пристойный
apt – годный, подходящий, соответствующий
biped – двуногое существо
bipedal – двуногий (two-legged, two-footed)
troop – стадо, отряд, войска, армия
hop – подпрыгивать, прыжок (skip, leap) хмель (бот.)
vivisection – вивисекция
vivisect – подвергать вивисекции
eliminate – устранять, исключать (remove, expel) уничтожать, ликвидировать
gully – овраг, канава, ров
gull – чайка
preposterous – абсурдный, нелепый (absurd, perverse, foolish, nonsensial)
perch – окунь (рыба); выступ, карниз (архитект.)
derogatory = derogative – унизительный, непочтительный, принижающий
skank – унизительный термин для девушки (страхолюдина, страшная как атомная война)
pimple, zit – прыщ (acne - прыщи)
wheelbarrow – тачка
barrow - тачка; ручная тележка
borrow - занимать, брать на время
lasagna – лазанья (кулинар.)
tummy – животик, пузо
complaint – жалоба (plaint)
elaborate – тщательно, детально продуманный
elaboratly - детально, тщательно; продуманно
choreographer – хореограф, балет-мастер (ballet-master)
choreograph – заниматься хореографией
chore – рутинная работа, работа по дому
misbehavior – аномальное поведение, неправильное функционирование
behavior = behaviour – хорошие манеры, хорошее поведение
weirdo – человек со странностями, извращенная личность
omen – знак, знамение, примета (presage, portent)
concern – отношения, касательство, касаться, относиться; дело, фирма, предприятие (business, firm)
slipper – тапочки
flipper – ласты, плавник
slippery – скользкий,
slip – скользить
slope – склон, наклон, уклон, откос
blitz = blitzkrieg – блицкриг, молниеносная война, стремительное нападение, наступление
bop – вид джазовой музыки (bebop)
mischief – озорство, проказы, бедокур, озорник
merriment – веселье, развлечение, радость (fun, mirth)
assistance – поддержка, помощь (help)
assistant – помощник, ассистент, подручный
prank – проказа, выходка, шалость, проделка (trick, freak)
peek – быстрый взгляд, взгляд украдкой, взглянуть, бросить взгляд (peep, keek, glance)
rife – обычный, частый, обыкновенный, распространенный (customary, usual)
gluttony – обжорство
glutton – обжора, гурман, любитель поесть
guttler – обжора
gormandizer – обжора
gourmet – гурман
junk – старье, рухлядь, хлам
vintage – старинный, классический
vin = wine – вино
accomplishment – достижение, успех (achievement, progress, attainment)
sloth – бездеятельность, лень (inactivity, laziness) лениться
pray = beg = entreat
conclude – завершать, закончить (finish)
include = comprise = contain = involve = comprehend
embrace – объятия, объятие, обниматься (hug)
